TITLE,SGY_JSK_QTY_2023-04-15,SGY_JSK_QTY_2023-03-15,CHANGE_AMOUNT,CHANGE(%),CATEGORY
0.003872,359,1,-358,-99.72,CAPA
0.002673792,1740,8,-1732,-99.54,CAPA
0.001573,112,1,-111,-99.11,CAPA
0.00595,95,1,-94,-98.95,CAPA
0.00135,296,4,-292,-98.65,CAPA
0.000234,473,7,-466,-98.52,CAPA
0.00120118,119,2,-117,-98.32,CAPA
0.0045225,54,1,-53,-98.15,CAPA
0.000984528,54,1,-53,-98.15,CAPA
0.004092,40,1,-39,-97.5,CAPA
0.007465176,186,5,-181,-97.31,CAPA
0.0010335,177,5,-172,-97.18,CAPA
0.000104,425,13,-412,-96.94,CAPA
0.000935,32,1,-31,-96.88,CAPA
0.00325248,94,3,-91,-96.81,CAPA
0.000456,94,3,-91,-96.81,CAPA
0.000806,59,2,-57,-96.61,CAPA
0.004224,183,7,-176,-96.17,CAPA
0.002584625,25,1,-24,-96.0,CAPA
0.00333,25,1,-24,-96.0,CAPA
0.0006475,142,6,-136,-95.77,CAPA
0.00049896,256,11,-245,-95.7,CAPA
0.001254,92,4,-88,-95.65,CAPA
0.002275,45,2,-43,-95.56,CAPA
0.006682104,44,2,-42,-95.45,CAPA
0.00539,22,1,-21,-95.45,CAPA
0.007236,150,7,-143,-95.33,CAPA
2.52e-05,21,1,-20,-95.24,CAPA
0.0041535,146,7,-139,-95.21,CAPA
3.52e-05,355,18,-337,-94.93,CAPA
0.00475524,95,5,-90,-94.74,CAPA
0.006864984,95,5,-90,-94.74,CAPA
0.01106677,19,1,-18,-94.74,CAPA
0.00065,205,11,-194,-94.63,CAPA
0.00056925,91,5,-86,-94.51,CAPA
0.002016,434,25,-409,-94.24,CAPA
0.000629,68,4,-64,-94.12,CAPA
0.000474525,34,2,-32,-94.12,CAPA
0.000735,75,5,-70,-93.33,CAPA
0.000455,208,14,-194,-93.27,CAPA
0.003162,41,3,-38,-92.68,CAPA
0.00063388,26,2,-24,-92.31,CAPA
0.000858,25,2,-23,-92.0,CAPA
0.001654653,11,1,-10,-90.91,CAPA
6.825e-05,22,2,-20,-90.91,CAPA
0.001089,53,5,-48,-90.57,CAPA
0.000544,21,2,-19,-90.48,CAPA
0.0001755,61,6,-55,-90.16,CAPA
0.0004675,28,3,-25,-89.29,CAPA
0.00171495,9,1,-8,-88.89,CAPA
0.001127,9,1,-8,-88.89,CAPA
0.00112,9,1,-8,-88.89,CAPA
0.00098,52,6,-46,-88.46,CAPA
0.000264,99,12,-87,-87.88,CAPA
0.0004485,277,34,-243,-87.73,CAPA
0.0005453,8,1,-7,-87.5,CAPA
0.0004375,8,1,-7,-87.5,CAPA
1.3e-05,54,7,-47,-87.04,CAPA
0.000119574,23,3,-20,-86.96,CAPA
0.012461568,457,60,-397,-86.87,CAPA
0.000531,15,2,-13,-86.67,CAPA
0.00033,160,22,-138,-86.25,CAPA
0.003,94,13,-81,-86.17,CAPA
0.000372,7,1,-6,-85.71,CAPA
0.001408,14,2,-12,-85.71,CAPA
0.00234,394,58,-336,-85.28,CAPA
0.003735,231,34,-197,-85.28,CAPA
0.00204,38,6,-32,-84.21,CAPA
0.0017928,6,1,-5,-83.33,CAPA
0.00072225,6,1,-5,-83.33,CAPA
0.00245,6,1,-5,-83.33,CAPA
1.98e-05,6,1,-5,-83.33,CAPA
0.000385,6,1,-5,-83.33,CAPA
0.00147,6,1,-5,-83.33,CAPA
0.00373175,6,1,-5,-83.33,CAPA
0.002904,177,30,-147,-83.05,CAPA
0.00088,11,2,-9,-81.82,CAPA
0.00165168,11,2,-9,-81.82,CAPA
0.00035075,10,2,-8,-80.0,CAPA
0.003726,5,1,-4,-80.0,CAPA
0.0001275,5,1,-4,-80.0,CAPA
0.00627,5,1,-4,-80.0,CAPA
0.000154652,5,1,-4,-80.0,CAPA
0.000153,15,3,-12,-80.0,CAPA
0.0002352,5,1,-4,-80.0,CAPA
0.00229104,5,1,-4,-80.0,CAPA
0.003276,5,1,-4,-80.0,CAPA
0.00528,5,1,-4,-80.0,CAPA
0.001331,141,31,-110,-78.01,CAPA
0.001053,8,2,-6,-75.0,CAPA
0.0003192,4,1,-3,-75.0,CAPA
0.000352,4,1,-3,-75.0,CAPA
3e-05,8,2,-6,-75.0,CAPA
0.0003276,4,1,-3,-75.0,CAPA
0.004914,68,17,-51,-75.0,CAPA
0.001615,4,1,-3,-75.0,CAPA
0.00014,31,8,-23,-74.19,CAPA
0.00024,157,43,-114,-72.61,CAPA
0.001623027,29,8,-21,-72.41,CAPA
0.00023925,7,2,-5,-71.43,CAPA
0.00145,7,2,-5,-71.43,CAPA
0.002508,7,2,-5,-71.43,CAPA
0.00031875,7,2,-5,-71.43,CAPA
0.003225,7,2,-5,-71.43,CAPA
0.000408,23,7,-16,-69.57,CAPA
0.001064,13,4,-9,-69.23,CAPA
0.000108,57,19,-38,-66.67,CAPA
0.000121,3,1,-2,-66.67,CAPA
0.00111228,3,1,-2,-66.67,CAPA
0.00208,3,1,-2,-66.67,CAPA
0.0001456,3,1,-2,-66.67,CAPA
0.0002553,3,1,-2,-66.67,CAPA
0.00012936,3,1,-2,-66.67,CAPA
0.002473192,6,2,-4,-66.67,CAPA
0.001274133,3,1,-2,-66.67,CAPA
0.00115804,3,1,-2,-66.67,CAPA
0.000120785,3,1,-2,-66.67,CAPA
0.000627,3,1,-2,-66.67,CAPA
0.000341,3,1,-2,-66.67,CAPA
5.2272e-05,3,1,-2,-66.67,CAPA
0.00423,9,3,-6,-66.67,CAPA
0.0003971,3,1,-2,-66.67,CAPA
0.001925,3,1,-2,-66.67,CAPA
0.0044,3,1,-2,-66.67,CAPA
0.000726,3,1,-2,-66.67,CAPA
0.000770303,3,1,-2,-66.67,CAPA
8.475e-05,6,2,-4,-66.67,CAPA
0.000204336,3,1,-2,-66.67,CAPA
0.000459375,3,1,-2,-66.67,CAPA
0.000468814,3,1,-2,-66.67,CAPA
9.1e-06,3,1,-2,-66.67,CAPA
0.00047061,3,1,-2,-66.67,CAPA
0.0092625,3,1,-2,-66.67,CAPA
0.0004455,3,1,-2,-66.67,CAPA
6.0025e-05,15,5,-10,-66.67,CAPA
0.0004104,3,1,-2,-66.67,CAPA
0.000156468,3,1,-2,-66.67,CAPA
0.001013166,3,1,-2,-66.67,CAPA
0.0001995,3,1,-2,-66.67,CAPA
0.00361,15,5,-10,-66.67,CAPA
6.51e-05,3,1,-2,-66.67,CAPA
0.00083993,3,1,-2,-66.67,CAPA
0.000343143,3,1,-2,-66.67,CAPA
0.0003485,3,1,-2,-66.67,CAPA
0.000135,71,24,-47,-66.2,CAPA
0.00016,35,12,-23,-65.71,CAPA
0.000132,33,12,-21,-63.64,CAPA
0.000423,11,4,-7,-63.64,CAPA
0.00356184,139,51,-88,-63.31,CAPA
0.002728,8,3,-5,-62.5,CAPA
0.000304,8,3,-5,-62.5,CAPA
9.9e-05,8,3,-5,-62.5,CAPA
0.000184824,8,3,-5,-62.5,CAPA
5e-05,16,6,-10,-62.5,CAPA
0.001256346,8,3,-5,-62.5,CAPA
3.6e-05,58,22,-36,-62.07,CAPA
0.00047073,13,5,-8,-61.54,CAPA
0.001056,5,2,-3,-60.0,CAPA
0.00085,5,2,-3,-60.0,CAPA
0.001903125,5,2,-3,-60.0,CAPA
0.0012075,10,4,-6,-60.0,CAPA
0.000242,5,2,-3,-60.0,CAPA
0.00040425,5,2,-3,-60.0,CAPA
1.4432e-05,37,15,-22,-59.46,CAPA
0.000192,32,13,-19,-59.38,CAPA
1.95e-05,22,9,-13,-59.09,CAPA
0.00048,116,49,-67,-57.76,CAPA
0.00052,7,3,-4,-57.14,CAPA
0.000105,498,216,-282,-56.63,CAPA
0.000891,18,8,-10,-55.56,CAPA
0.000546,9,4,-5,-55.56,CAPA
0.000165,20,9,-11,-55.0,CAPA
1.8e-05,40,18,-22,-55.0,CAPA
0.000453125,11,5,-6,-54.55,CAPA
0.00304,24,11,-13,-54.17,CAPA
0.00066612,13,6,-7,-53.85,CAPA
0.000189,19,9,-10,-52.63,CAPA
0.000225,68,33,-35,-51.47,CAPA
0.000144,384,191,-193,-50.26,CAPA
0.001754896,8,4,-4,-50.0,CAPA
0.001683,2,1,-1,-50.0,CAPA
0.001575,2,1,-1,-50.0,CAPA
0.001791396,2,1,-1,-50.0,CAPA
0.0002295,4,2,-2,-50.0,CAPA
0.0009975,2,1,-1,-50.0,CAPA
0.000244375,4,2,-2,-50.0,CAPA
0.00047915,2,1,-1,-50.0,CAPA
0.000513216,2,1,-1,-50.0,CAPA
0.000477326,2,1,-1,-50.0,CAPA
0.00053196,2,1,-1,-50.0,CAPA
0.00059334,2,1,-1,-50.0,CAPA
0.000448,4,2,-2,-50.0,CAPA
0.000433125,2,1,-1,-50.0,CAPA
0.032,2,1,-1,-50.0,CAPA
0.000643336,2,1,-1,-50.0,CAPA
0.000654,2,1,-1,-50.0,CAPA
0.0007175,2,1,-1,-50.0,CAPA
0.0007308,4,2,-2,-50.0,CAPA
0.000731136,2,1,-1,-50.0,CAPA
0.000392,10,5,-5,-50.0,CAPA
0.000391875,2,1,-1,-50.0,CAPA
0.000784,2,1,-1,-50.0,CAPA
0.00037125,4,2,-2,-50.0,CAPA
0.00088125,4,2,-2,-50.0,CAPA
0.000986,2,1,-1,-50.0,CAPA
0.001092,6,3,-3,-50.0,CAPA
0.00030375,10,5,-5,-50.0,CAPA
0.00030294,4,2,-2,-50.0,CAPA
0.0002926,2,1,-1,-50.0,CAPA
0.001157312,4,2,-2,-50.0,CAPA
0.001176768,2,1,-1,-50.0,CAPA
0.00026928,2,1,-1,-50.0,CAPA
0.00128975,2,1,-1,-50.0,CAPA
0.00154629,2,1,-1,-50.0,CAPA
0.0001989,2,1,-1,-50.0,CAPA
0.001650348,2,1,-1,-50.0,CAPA
0.003483864,6,3,-3,-50.0,CAPA
0.0075,2,1,-1,-50.0,CAPA
0.0096,4,2,-2,-50.0,CAPA
2.8875e-05,4,2,-2,-50.0,CAPA
9.8e-05,4,2,-2,-50.0,CAPA
0.0051338,2,1,-1,-50.0,CAPA
0.0001512,2,1,-1,-50.0,CAPA
2.496e-06,2,1,-1,-50.0,CAPA
0.00247,10,5,-5,-50.0,CAPA
0.003975192,2,1,-1,-50.0,CAPA
0.002172421,2,1,-1,-50.0,CAPA
8.1e-05,28,14,-14,-50.0,CAPA
0.00193725,2,1,-1,-50.0,CAPA
0.003332,2,1,-1,-50.0,CAPA
0.000195,10,5,-5,-50.0,CAPA
0.0029925,2,1,-1,-50.0,CAPA
0.00018225,4,2,-2,-50.0,CAPA
0.00018774,4,2,-2,-50.0,CAPA
8.2992e-05,10,5,-5,-50.0,CAPA
4.83e-05,2,1,-1,-50.0,CAPA
0.0051,2,1,-1,-50.0,CAPA
0.00342,2,1,-1,-50.0,CAPA
0.00027,27,14,-13,-48.15,CAPA
0.0018081,19,10,-9,-47.37,CAPA
0.00038125,15,8,-7,-46.67,CAPA
0.00525525,11,6,-5,-45.45,CAPA
0.00041184,33,18,-15,-45.45,CAPA
0.000874125,42,23,-19,-45.24,CAPA
6.6e-05,34,19,-15,-44.12,CAPA
4.8e-05,48,27,-21,-43.75,CAPA
0.001694,14,8,-6,-42.86,CAPA
0.0013752,7,4,-3,-42.86,CAPA
0.0010602,12,7,-5,-41.67,CAPA
0.000465,5,3,-2,-40.0,CAPA
0.00062475,5,3,-2,-40.0,CAPA
0.005661696,10,6,-4,-40.0,CAPA
0.000595,5,3,-2,-40.0,CAPA
0.000765,5,3,-2,-40.0,CAPA
0.00155316,5,3,-2,-40.0,CAPA
0.0048,10,6,-4,-40.0,CAPA
0.000572,23,14,-9,-39.13,CAPA
0.00069,317,194,-123,-38.8,CAPA
0.00023625,8,5,-3,-37.5,CAPA
0.006555168,16,10,-6,-37.5,CAPA
0.000898008,8,5,-3,-37.5,CAPA
0.00144,25,16,-9,-36.0,CAPA
0.000511058,25,16,-9,-36.0,CAPA
0.0009,39,25,-14,-35.9,CAPA
0.000805,251,162,-89,-35.46,CAPA
0.000576,20,13,-7,-35.0,CAPA
0.000594,40,26,-14,-35.0,CAPA
0.000748,3,2,-1,-33.33,CAPA
0.0003875,3,2,-1,-33.33,CAPA
5.5944e-05,3,2,-1,-33.33,CAPA
2.88e-05,3,2,-1,-33.33,CAPA
0.0035815,12,8,-4,-33.33,CAPA
0.0006384,3,2,-1,-33.33,CAPA
0.00387,3,2,-1,-33.33,CAPA
0.00032736,9,6,-3,-33.33,CAPA
0.0001224,6,4,-2,-33.33,CAPA
7.8e-05,18,12,-6,-33.33,CAPA
0.00081,6,4,-2,-33.33,CAPA
0.003968,12,8,-4,-33.33,CAPA
0.00011025,3,2,-1,-33.33,CAPA
0.008444784,3,2,-1,-33.33,CAPA
0.00015675,3,2,-1,-33.33,CAPA
0.00018105,3,2,-1,-33.33,CAPA
1.4596e-05,15,10,-5,-33.33,CAPA
0.000459954,3,2,-1,-33.33,CAPA
0.00189,3,2,-1,-33.33,CAPA
0.0001305,3,2,-1,-33.33,CAPA
0.00051744,3,2,-1,-33.33,CAPA
0.002406616,3,2,-1,-33.33,CAPA
0.000945,16,11,-5,-31.25,CAPA
0.00064,45,31,-14,-31.11,CAPA
0.003906,10,7,-3,-30.0,CAPA
0.000143856,10,7,-3,-30.0,CAPA
3.6e-06,14,10,-4,-28.57,CAPA
0.000133,7,5,-2,-28.57,CAPA
6.0885e-05,28,20,-8,-28.57,CAPA
0.003024,15,11,-4,-26.67,CAPA
0.000441,23,17,-6,-26.09,CAPA
3.78e-05,12,9,-3,-25.0,CAPA
0.0002275,4,3,-1,-25.0,CAPA
0.0003375,4,3,-1,-25.0,CAPA
0.001794,4,3,-1,-25.0,CAPA
0.000819,4,3,-1,-25.0,CAPA
0.003864,4,3,-1,-25.0,CAPA
0.002048,4,3,-1,-25.0,CAPA
0.001035,4,3,-1,-25.0,CAPA
0.00118125,4,3,-1,-25.0,CAPA
0.000123,24,18,-6,-25.0,CAPA
0.000621,4,3,-1,-25.0,CAPA
0.00114,8,6,-2,-25.0,CAPA
0.00045024,4,3,-1,-25.0,CAPA
0.00165,12,9,-3,-25.0,CAPA
0.00043875,8,6,-2,-25.0,CAPA
0.000375,22,17,-5,-22.73,CAPA
1.408e-05,80,63,-17,-21.25,CAPA
0.00034,24,19,-5,-20.83,CAPA
0.001628,5,4,-1,-20.0,CAPA
0.001528914,5,4,-1,-20.0,CAPA
0.00190485,5,4,-1,-20.0,CAPA
0.000156,15,12,-3,-20.0,CAPA
7.524e-05,5,4,-1,-20.0,CAPA
0.000396,60,48,-12,-20.0,CAPA
0.0004851,5,4,-1,-20.0,CAPA
0.000374738,5,4,-1,-20.0,CAPA
0.003025,5,4,-1,-20.0,CAPA
4.5e-05,52,43,-9,-17.31,CAPA
0.000882,12,10,-2,-16.67,CAPA
0.000903,6,5,-1,-16.67,CAPA
0.000102,6,5,-1,-16.67,CAPA
0.004032,18,15,-3,-16.67,CAPA
0.0001575,25,21,-4,-16.0,CAPA
0.001508232,13,11,-2,-15.38,CAPA
0.002484,299,256,-43,-14.38,CAPA
0.000117504,7,6,-1,-14.29,CAPA
0.004332,21,18,-3,-14.29,CAPA
0.003703,8,7,-1,-12.5,CAPA
0.000224,33,29,-4,-12.12,CAPA
0.0001377,17,15,-2,-11.76,CAPA
0.000759375,9,8,-1,-11.11,CAPA
7.2e-06,50,45,-5,-10.0,CAPA
8.1396e-05,11,10,-1,-9.09,CAPA
0.00169756,12,11,-1,-8.33,CAPA
0.00013,14,13,-1,-7.14,CAPA
0.00105,14,13,-1,-7.14,CAPA
5.94e-05,31,29,-2,-6.45,CAPA
0.00108,36,35,-1,-2.78,CAPA
0.0008,74,72,-2,-2.7,CAPA
0.00063,49,48,-1,-2.04,CAPA
