TITLE,SGY_JSK_QTY_2023-04-15,SGY_JSK_QTY_2023-03-15,CHANGE_AMOUNT,CHANGE(%),CATEGORY
72151310,1,110,-109,-10900.0,FD_BUNRUI
86416010,1,67,-66,-6600.0,FD_BUNRUI
77116031,1,63,-62,-6200.0,FD_BUNRUI
72160410,1,44,-43,-4300.0,FD_BUNRUI
11608080,1,43,-42,-4200.0,FD_BUNRUI
77573024,2,75,-73,-3650.0,FD_BUNRUI
56505050,4,112,-108,-2700.0,FD_BUNRUI
12408212,1,25,-24,-2400.0,FD_BUNRUI
33151030,1,24,-23,-2300.0,FD_BUNRUI
63814210,1,21,-20,-2000.0,FD_BUNRUI
51708282,2,38,-36,-1800.0,FD_BUNRUI
47401010,1,18,-17,-1700.0,FD_BUNRUI
45405010,1,17,-16,-1600.0,FD_BUNRUI
45406020,1,17,-16,-1600.0,FD_BUNRUI
35183010,17,257,-240,-1411.76,FD_BUNRUI
63813333,1,15,-14,-1400.0,FD_BUNRUI
45403040,3,42,-39,-1300.0,FD_BUNRUI
71112001,4,52,-48,-1200.0,FD_BUNRUI
63305050,1,12,-11,-1100.0,FD_BUNRUI
13302310,1,12,-11,-1100.0,FD_BUNRUI
33174010,4,47,-43,-1075.0,FD_BUNRUI
45401020,1,11,-10,-1000.0,FD_BUNRUI
45101020,8,77,-69,-862.5,FD_BUNRUI
64710308,86,782,-696,-809.3,FD_BUNRUI
64710334,16,142,-126,-787.5,FD_BUNRUI
56831010,28,231,-203,-725.0,FD_BUNRUI
64710309,64,525,-461,-720.31,FD_BUNRUI
63305052,5,41,-36,-720.0,FD_BUNRUI
63813232,1,8,-7,-700.0,FD_BUNRUI
12723030,2,16,-14,-700.0,FD_BUNRUI
45103010,23,184,-161,-700.0,FD_BUNRUI
35171010,1,8,-7,-700.0,FD_BUNRUI
63819363,1,8,-7,-700.0,FD_BUNRUI
45303020,14,111,-97,-692.86,FD_BUNRUI
13302110,2,15,-13,-650.0,FD_BUNRUI
64710804,4,30,-26,-650.0,FD_BUNRUI
15606060,22,155,-133,-604.55,FD_BUNRUI
15606061,4,28,-24,-600.0,FD_BUNRUI
77215014,1,7,-6,-600.0,FD_BUNRUI
63816363,1,7,-6,-600.0,FD_BUNRUI
12720020,1,7,-6,-600.0,FD_BUNRUI
63705052,1,7,-6,-600.0,FD_BUNRUI
63815456,2,13,-11,-550.0,FD_BUNRUI
36252010,3,18,-15,-500.0,FD_BUNRUI
64710333,1,6,-5,-500.0,FD_BUNRUI
45105020,5,28,-23,-460.0,FD_BUNRUI
45202010,5,27,-22,-440.0,FD_BUNRUI
33151010,23,123,-100,-434.78,FD_BUNRUI
63815454,3,16,-13,-433.33,FD_BUNRUI
63305353,12,62,-50,-416.67,FD_BUNRUI
47504444,3,15,-12,-400.0,FD_BUNRUI
63832910,2,10,-8,-400.0,FD_BUNRUI
64710806,16,72,-56,-350.0,FD_BUNRUI
35182020,4,18,-14,-350.0,FD_BUNRUI
56203030,13,58,-45,-346.15,FD_BUNRUI
36252040,16,69,-53,-331.25,FD_BUNRUI
45202030,4,17,-13,-325.0,FD_BUNRUI
71410002,5,20,-15,-300.0,FD_BUNRUI
53202027,1,4,-3,-300.0,FD_BUNRUI
64751010,2,8,-6,-300.0,FD_BUNRUI
45105010,1,4,-3,-300.0,FD_BUNRUI
45406010,1,4,-3,-300.0,FD_BUNRUI
64710814,64,254,-190,-296.88,FD_BUNRUI
63815254,5,19,-14,-280.0,FD_BUNRUI
51407171,9,33,-24,-266.67,FD_BUNRUI
32503030,3,11,-8,-266.67,FD_BUNRUI
45304010,3,11,-8,-266.67,FD_BUNRUI
71410000,28,100,-72,-257.14,FD_BUNRUI
21860401,2,7,-5,-250.0,FD_BUNRUI
45403050,9,31,-22,-244.44,FD_BUNRUI
64710314,85,289,-204,-240.0,FD_BUNRUI
43812525,11,37,-26,-236.36,FD_BUNRUI
63813210,6,20,-14,-233.33,FD_BUNRUI
12402111,3,10,-7,-233.33,FD_BUNRUI
86417020,4,13,-9,-225.0,FD_BUNRUI
64710311,26,80,-54,-207.69,FD_BUNRUI
64710809,3,9,-6,-200.0,FD_BUNRUI
12402110,2,6,-4,-200.0,FD_BUNRUI
45403020,5,15,-10,-200.0,FD_BUNRUI
64710360,1,3,-2,-200.0,FD_BUNRUI
71704040,4,12,-8,-200.0,FD_BUNRUI
45702030,1,3,-2,-200.0,FD_BUNRUI
45810000,9,27,-18,-200.0,FD_BUNRUI
63705353,1,3,-2,-200.0,FD_BUNRUI
53202037,1,3,-2,-200.0,FD_BUNRUI
63704141,1,3,-2,-200.0,FD_BUNRUI
71410020,6,17,-11,-183.33,FD_BUNRUI
47503131,12,34,-22,-183.33,FD_BUNRUI
12723020,5,14,-9,-180.0,FD_BUNRUI
64710000,5,14,-9,-180.0,FD_BUNRUI
64710811,24,67,-43,-179.17,FD_BUNRUI
13302120,4,11,-7,-175.0,FD_BUNRUI
64710310,23,63,-40,-173.91,FD_BUNRUI
15110000,15,41,-26,-173.33,FD_BUNRUI
63818181,40,109,-69,-172.5,FD_BUNRUI
64710350,26,70,-44,-169.23,FD_BUNRUI
71210080,9,24,-15,-166.67,FD_BUNRUI
43702020,17,45,-28,-164.71,FD_BUNRUI
63305253,7,18,-11,-157.14,FD_BUNRUI
51607171,11,28,-17,-154.55,FD_BUNRUI
64710813,28,71,-43,-153.57,FD_BUNRUI
21302020,10,25,-15,-150.0,FD_BUNRUI
47810303,2,5,-3,-150.0,FD_BUNRUI
71380000,15,37,-22,-146.67,FD_BUNRUI
63832011,41,100,-59,-143.9,FD_BUNRUI
71610000,5,12,-7,-140.0,FD_BUNRUI
71320030,12,28,-16,-133.33,FD_BUNRUI
45104010,35,81,-46,-131.43,FD_BUNRUI
63701010,49,113,-64,-130.61,FD_BUNRUI
63831021,95,219,-124,-130.53,FD_BUNRUI
21602060,17,39,-22,-129.41,FD_BUNRUI
15603030,12,27,-15,-125.0,FD_BUNRUI
77115038,8,18,-10,-125.0,FD_BUNRUI
63813838,5,11,-6,-120.0,FD_BUNRUI
25603510,8,17,-9,-112.5,FD_BUNRUI
63813270,22,46,-24,-109.09,FD_BUNRUI
71113002,23,47,-24,-104.35,FD_BUNRUI
64710331,31,63,-32,-103.23,FD_BUNRUI
35181010,1,2,-1,-100.0,FD_BUNRUI
12732012,1,2,-1,-100.0,FD_BUNRUI
63815959,1,2,-1,-100.0,FD_BUNRUI
21860501,1,2,-1,-100.0,FD_BUNRUI
35182030,1,2,-1,-100.0,FD_BUNRUI
64710920,2,4,-2,-100.0,FD_BUNRUI
64807171,1,2,-1,-100.0,FD_BUNRUI
71110001,10,20,-10,-100.0,FD_BUNRUI
36212010,1,2,-1,-100.0,FD_BUNRUI
32209010,3,6,-3,-100.0,FD_BUNRUI
21860601,1,2,-1,-100.0,FD_BUNRUI
12601010,1,2,-1,-100.0,FD_BUNRUI
63815455,6,12,-6,-100.0,FD_BUNRUI
45201030,28,56,-28,-100.0,FD_BUNRUI
21100610,2,4,-2,-100.0,FD_BUNRUI
63813435,1,2,-1,-100.0,FD_BUNRUI
12723040,1,2,-1,-100.0,FD_BUNRUI
63818686,2,4,-2,-100.0,FD_BUNRUI
86379010,1,2,-1,-100.0,FD_BUNRUI
41810000,3,6,-3,-100.0,FD_BUNRUI
12204310,1,2,-1,-100.0,FD_BUNRUI
18301050,125,247,-122,-97.6,FD_BUNRUI
71113001,58,114,-56,-96.55,FD_BUNRUI
64710313,227,431,-204,-89.87,FD_BUNRUI
71111003,472,867,-395,-83.69,FD_BUNRUI
64710316,36,66,-30,-83.33,FD_BUNRUI
63812929,32,58,-26,-81.25,FD_BUNRUI
64710335,5,9,-4,-80.0,FD_BUNRUI
63819313,4,7,-3,-75.0,FD_BUNRUI
57201111,11,19,-8,-72.73,FD_BUNRUI
35182010,7,12,-5,-71.43,FD_BUNRUI
47406110,3,5,-2,-66.67,FD_BUNRUI
63831010,42,70,-28,-66.67,FD_BUNRUI
47810000,3,5,-2,-66.67,FD_BUNRUI
18634040,17,28,-11,-64.71,FD_BUNRUI
92128080,13,21,-8,-61.54,FD_BUNRUI
64710810,54,85,-31,-57.41,FD_BUNRUI
18611010,15,23,-8,-53.33,FD_BUNRUI
45201040,38,58,-20,-52.63,FD_BUNRUI
63831011,178,268,-90,-50.56,FD_BUNRUI
71111006,16,24,-8,-50.0,FD_BUNRUI
60801050,2,3,-1,-50.0,FD_BUNRUI
18611515,2,3,-1,-50.0,FD_BUNRUI
56205050,6,9,-3,-50.0,FD_BUNRUI
63705253,10,15,-5,-50.0,FD_BUNRUI
77213011,2,3,-1,-50.0,FD_BUNRUI
15601010,17,25,-8,-47.06,FD_BUNRUI
71326060,35,50,-15,-42.86,FD_BUNRUI
18301010,45,64,-19,-42.22,FD_BUNRUI
76102121,5,7,-2,-40.0,FD_BUNRUI
71701010,5,7,-2,-40.0,FD_BUNRUI
36253030,78,109,-31,-39.74,FD_BUNRUI
18630000,13,18,-5,-38.46,FD_BUNRUI
53207373,21,29,-8,-38.1,FD_BUNRUI
64710315,83,111,-28,-33.73,FD_BUNRUI
63818989,110,147,-37,-33.64,FD_BUNRUI
43811010,3,4,-1,-33.33,FD_BUNRUI
21302424,12,16,-4,-33.33,FD_BUNRUI
64710318,6,8,-2,-33.33,FD_BUNRUI
63816666,3,4,-1,-33.33,FD_BUNRUI
45201050,9,12,-3,-33.33,FD_BUNRUI
36252020,12,16,-4,-33.33,FD_BUNRUI
11610000,113,147,-34,-30.09,FD_BUNRUI
45810505,49,63,-14,-28.57,FD_BUNRUI
63816565,8,10,-2,-25.0,FD_BUNRUI
21302121,4,5,-1,-25.0,FD_BUNRUI
12727010,4,5,-1,-25.0,FD_BUNRUI
15132525,4,5,-1,-25.0,FD_BUNRUI
63813636,4,5,-1,-25.0,FD_BUNRUI
71211030,12,15,-3,-25.0,FD_BUNRUI
63831110,13,16,-3,-23.08,FD_BUNRUI
18634545,10,12,-2,-20.0,FD_BUNRUI
63832012,26,31,-5,-19.23,FD_BUNRUI
63813260,42,50,-8,-19.05,FD_BUNRUI
71310040,27,31,-4,-14.81,FD_BUNRUI
71310030,7,8,-1,-14.29,FD_BUNRUI
45201020,114,128,-14,-12.28,FD_BUNRUI
33134010,9,10,-1,-11.11,FD_BUNRUI
63813230,157,174,-17,-10.83,FD_BUNRUI
63812424,37,41,-4,-10.81,FD_BUNRUI
18617010,10,11,-1,-10.0,FD_BUNRUI
64710803,10,11,-1,-10.0,FD_BUNRUI
71510005,35,38,-3,-8.57,FD_BUNRUI
53101515,43,46,-3,-6.98,FD_BUNRUI
71323535,44,47,-3,-6.82,FD_BUNRUI
71111004,422,449,-27,-6.4,FD_BUNRUI
64710317,51,54,-3,-5.88,FD_BUNRUI
43702525,19,20,-1,-5.26,FD_BUNRUI
71211020,127,131,-4,-3.15,FD_BUNRUI
