TITLE,SGY_JSK_QTY_2023-04-15,SGY_JSK_QTY_2023-03-15,CHANGE_AMOUNT,CHANGE(%),CATEGORY
4549550272056,5,223,-218,-4360.0,JAN_CD
9760107820529,1,41,-40,-4000.0,JAN_CD
4571411192760,1,40,-39,-3900.0,JAN_CD
4582353597636,3,93,-90,-3000.0,JAN_CD
885155019493,1,29,-28,-2800.0,JAN_CD
4549550272414,1,28,-27,-2700.0,JAN_CD
4580350280810,1,26,-25,-2500.0,JAN_CD
4549980443576,1,22,-21,-2100.0,JAN_CD
4549550272049,4,81,-77,-1925.0,JAN_CD
4517228031076,2,40,-38,-1900.0,JAN_CD
4988075700147,1,19,-18,-1800.0,JAN_CD
4522327945049,1,18,-17,-1700.0,JAN_CD
4522327945087,1,18,-17,-1700.0,JAN_CD
4547410377231,9,155,-146,-1622.22,JAN_CD
4549550236669,2,34,-32,-1600.0,JAN_CD
4582267399890,5,83,-78,-1560.0,JAN_CD
3045386381265,3,49,-46,-1533.33,JAN_CD
4995860514780,3,45,-42,-1400.0,JAN_CD
4571411200151,1,14,-13,-1300.0,JAN_CD
4988075704695,1,14,-13,-1300.0,JAN_CD
4589440761031,1,14,-13,-1300.0,JAN_CD
4571411195839,1,14,-13,-1300.0,JAN_CD
4582269540917,1,12,-11,-1100.0,JAN_CD
4549550173780,1,12,-11,-1100.0,JAN_CD
4549550137324,1,12,-11,-1100.0,JAN_CD
4549980616819,1,12,-11,-1100.0,JAN_CD
4943765058731,1,11,-10,-1000.0,JAN_CD
4902710708930,1,11,-10,-1000.0,JAN_CD
4988075698338,1,10,-9,-900.0,JAN_CD
4902901776984,1,10,-9,-900.0,JAN_CD
4582521680061,1,10,-9,-900.0,JAN_CD
4902704240651,1,10,-9,-900.0,JAN_CD
4589440761048,1,10,-9,-900.0,JAN_CD
4549980652640,2,19,-17,-850.0,JAN_CD
4549980595770,2,19,-17,-850.0,JAN_CD
4518707301642,1,9,-8,-800.0,JAN_CD
4960999484112,1,9,-8,-800.0,JAN_CD
4967576568104,2,18,-16,-800.0,JAN_CD
4960999484129,1,9,-8,-800.0,JAN_CD
4571411195099,1,9,-8,-800.0,JAN_CD
4582269540825,1,9,-8,-800.0,JAN_CD
4907990302632,1,9,-8,-800.0,JAN_CD
4571411199257,2,16,-14,-700.0,JAN_CD
4580548442686,1,8,-7,-700.0,JAN_CD
4978877204233,1,8,-7,-700.0,JAN_CD
4571411203305,1,8,-7,-700.0,JAN_CD
4580350283941,3,24,-21,-700.0,JAN_CD
4969887836491,1,8,-7,-700.0,JAN_CD
4907986022049,1,8,-7,-700.0,JAN_CD
4969887836347,1,8,-7,-700.0,JAN_CD
4988075696358,1,8,-7,-700.0,JAN_CD
4549550249065,2,16,-14,-700.0,JAN_CD
4988075700055,1,8,-7,-700.0,JAN_CD
4549550249201,2,15,-13,-650.0,JAN_CD
4547410377224,8,59,-51,-637.5,JAN_CD
4971275605862,1,7,-6,-600.0,JAN_CD
4580366820741,2,14,-12,-600.0,JAN_CD
4548736062221,1,7,-6,-600.0,JAN_CD
4969887836323,1,7,-6,-600.0,JAN_CD
4975302275097,1,7,-6,-600.0,JAN_CD
4582269541297,1,7,-6,-600.0,JAN_CD
4988617158207,1,7,-6,-600.0,JAN_CD
4562191602037,1,7,-6,-600.0,JAN_CD
4960999484075,2,13,-11,-550.0,JAN_CD
4571163365061,18,113,-95,-527.78,JAN_CD
4943765058748,1,6,-5,-500.0,JAN_CD
4967576452328,1,6,-5,-500.0,JAN_CD
4969887268254,1,6,-5,-500.0,JAN_CD
4969887744284,1,6,-5,-500.0,JAN_CD
4967576411554,1,6,-5,-500.0,JAN_CD
4549550126182,1,6,-5,-500.0,JAN_CD
4905524850529,1,6,-5,-500.0,JAN_CD
4966307308866,1,6,-5,-500.0,JAN_CD
4548736036895,1,6,-5,-500.0,JAN_CD
4580625137184,1,6,-5,-500.0,JAN_CD
4006387115173,1,6,-5,-500.0,JAN_CD
4971275055438,1,6,-5,-500.0,JAN_CD
4549550261807,1,6,-5,-500.0,JAN_CD
4549550262224,1,6,-5,-500.0,JAN_CD
4549550263238,1,6,-5,-500.0,JAN_CD
4549980046616,1,6,-5,-500.0,JAN_CD
4549980352571,1,6,-5,-500.0,JAN_CD
4549980652657,1,6,-5,-500.0,JAN_CD
4984824160972,5,30,-25,-500.0,JAN_CD
4522327945971,1,6,-5,-500.0,JAN_CD
4978877204059,1,6,-5,-500.0,JAN_CD
4977187106602,2,12,-10,-500.0,JAN_CD
4571411198779,1,6,-5,-500.0,JAN_CD
4902901777004,2,12,-10,-500.0,JAN_CD
4526397107215,1,6,-5,-500.0,JAN_CD
4571411203039,1,6,-5,-500.0,JAN_CD
4549980550786,3,17,-14,-466.67,JAN_CD
4549292045338,2,11,-9,-450.0,JAN_CD
4549550142908,2,11,-9,-450.0,JAN_CD
4580383620683,3,16,-13,-433.33,JAN_CD
4904530027529,7,36,-29,-414.29,JAN_CD
4582521680108,4,20,-16,-400.0,JAN_CD
4573176154953,1,5,-4,-400.0,JAN_CD
4976680274207,1,5,-4,-400.0,JAN_CD
4582269540863,2,10,-8,-400.0,JAN_CD
4942322009353,1,5,-4,-400.0,JAN_CD
4906186512916,1,5,-4,-400.0,JAN_CD
4549550208192,1,5,-4,-400.0,JAN_CD
4549550203982,1,5,-4,-400.0,JAN_CD
5707055057700,2,10,-8,-400.0,JAN_CD
4901087187805,2,10,-8,-400.0,JAN_CD
4969887836361,1,5,-4,-400.0,JAN_CD
4943765060635,1,5,-4,-400.0,JAN_CD
4582269540696,1,5,-4,-400.0,JAN_CD
4967576568029,4,20,-16,-400.0,JAN_CD
4571411201530,2,10,-8,-400.0,JAN_CD
4571411193736,2,10,-8,-400.0,JAN_CD
4549980597507,2,10,-8,-400.0,JAN_CD
4969887747032,1,5,-4,-400.0,JAN_CD
4969887667682,1,5,-4,-400.0,JAN_CD
4571411195259,2,9,-7,-350.0,JAN_CD
4988075701847,2,9,-7,-350.0,JAN_CD
4562344381130,2,9,-7,-350.0,JAN_CD
4960999484105,2,9,-7,-350.0,JAN_CD
4549980636831,2,9,-7,-350.0,JAN_CD
4984824760752,10,44,-34,-340.0,JAN_CD
4903456199341,13,57,-44,-338.46,JAN_CD
4549550143776,16,70,-54,-337.5,JAN_CD
4902901932243,3,13,-10,-333.33,JAN_CD
4549292132304,1,4,-3,-300.0,JAN_CD
4580256088015,1,4,-3,-300.0,JAN_CD
4902704241641,1,4,-3,-300.0,JAN_CD
4580657302444,1,4,-3,-300.0,JAN_CD
4549980595589,1,4,-3,-300.0,JAN_CD
4549980595305,1,4,-3,-300.0,JAN_CD
4549550215053,2,8,-6,-300.0,JAN_CD
4570065981140,1,4,-3,-300.0,JAN_CD
4549980263402,1,4,-3,-300.0,JAN_CD
4580212310235,1,4,-3,-300.0,JAN_CD
4901087216925,1,4,-3,-300.0,JAN_CD
4549526303005,1,4,-3,-300.0,JAN_CD
4582269541273,1,4,-3,-300.0,JAN_CD
4580383621345,1,4,-3,-300.0,JAN_CD
4580256070522,1,4,-3,-300.0,JAN_CD
4562344366410,2,8,-6,-300.0,JAN_CD
4589946770018,1,4,-3,-300.0,JAN_CD
4549980188927,2,8,-6,-300.0,JAN_CD
4549292185133,2,8,-6,-300.0,JAN_CD
4549550175906,1,4,-3,-300.0,JAN_CD
4904323403219,1,4,-3,-300.0,JAN_CD
4988075703827,1,4,-3,-300.0,JAN_CD
4988075694644,2,8,-6,-300.0,JAN_CD
4984824667051,2,8,-6,-300.0,JAN_CD
4953103497306,1,4,-3,-300.0,JAN_CD
4943765060505,1,4,-3,-300.0,JAN_CD
4943765060581,1,4,-3,-300.0,JAN_CD
4549077898562,1,4,-3,-300.0,JAN_CD
4988075705760,2,8,-6,-300.0,JAN_CD
4953103481800,1,4,-3,-300.0,JAN_CD
4988075691209,1,4,-3,-300.0,JAN_CD
4988075697614,1,4,-3,-300.0,JAN_CD
4988075698253,1,4,-3,-300.0,JAN_CD
4972353436668,1,4,-3,-300.0,JAN_CD
4988075701823,1,4,-3,-300.0,JAN_CD
4988075700031,1,4,-3,-300.0,JAN_CD
4522327946336,1,4,-3,-300.0,JAN_CD
4518707301383,1,4,-3,-300.0,JAN_CD
4984824829046,1,4,-3,-300.0,JAN_CD
4967576248662,1,4,-3,-300.0,JAN_CD
4969887782026,1,4,-3,-300.0,JAN_CD
4969887781968,1,4,-3,-300.0,JAN_CD
4991348084974,1,4,-3,-300.0,JAN_CD
4967576648233,1,4,-3,-300.0,JAN_CD
4981747078230,1,4,-3,-300.0,JAN_CD
4522327946312,1,4,-3,-300.0,JAN_CD
4953103373297,1,4,-3,-300.0,JAN_CD
4978877265852,1,4,-3,-300.0,JAN_CD
4523608026266,1,4,-3,-300.0,JAN_CD
4977766761901,1,4,-3,-300.0,JAN_CD
4967576300520,1,4,-3,-300.0,JAN_CD
4522327945100,1,4,-3,-300.0,JAN_CD
4988075691711,1,4,-3,-300.0,JAN_CD
4902901777042,28,108,-80,-285.71,JAN_CD
4967576568081,14,53,-39,-278.57,JAN_CD
4901087190218,3,11,-8,-266.67,JAN_CD
4580256070478,2,7,-5,-250.0,JAN_CD
4549550203876,2,7,-5,-250.0,JAN_CD
4971275617599,2,7,-5,-250.0,JAN_CD
4549550264402,2,7,-5,-250.0,JAN_CD
4943765059615,2,7,-5,-250.0,JAN_CD
4988338221822,2,7,-5,-250.0,JAN_CD
4549292131895,2,7,-5,-250.0,JAN_CD
4974305222299,2,7,-5,-250.0,JAN_CD
4902580793623,2,7,-5,-250.0,JAN_CD
4902901777080,13,45,-32,-246.15,JAN_CD
4549077898548,3,10,-7,-233.33,JAN_CD
4582521680092,3,10,-7,-233.33,JAN_CD
4580657302758,3,10,-7,-233.33,JAN_CD
4902704242303,12,40,-28,-233.33,JAN_CD
4582267399906,7,23,-16,-228.57,JAN_CD
4549077898975,4,13,-9,-225.0,JAN_CD
4967576300537,4,13,-9,-225.0,JAN_CD
4902901777066,4,13,-9,-225.0,JAN_CD
4549980668306,1,3,-2,-200.0,JAN_CD
4988075468412,1,3,-2,-200.0,JAN_CD
4560158875784,1,3,-2,-200.0,JAN_CD
4562344367363,1,3,-2,-200.0,JAN_CD
4984824303201,1,3,-2,-200.0,JAN_CD
4988075696860,1,3,-2,-200.0,JAN_CD
4549980596395,3,9,-6,-200.0,JAN_CD
4991348079154,1,3,-2,-200.0,JAN_CD
4991348064181,1,3,-2,-200.0,JAN_CD
4549550242837,1,3,-2,-200.0,JAN_CD
4549550248273,1,3,-2,-200.0,JAN_CD
4988617361713,1,3,-2,-200.0,JAN_CD
4988617017610,1,3,-2,-200.0,JAN_CD
4549550250566,1,3,-2,-200.0,JAN_CD
4549550253802,1,3,-2,-200.0,JAN_CD
4988617017559,1,3,-2,-200.0,JAN_CD
4549550263627,1,3,-2,-200.0,JAN_CD
4988075703780,1,3,-2,-200.0,JAN_CD
4988075702196,1,3,-2,-200.0,JAN_CD
4988075701922,1,3,-2,-200.0,JAN_CD
4988075698468,1,3,-2,-200.0,JAN_CD
4549980595886,1,3,-2,-200.0,JAN_CD
4988075665422,1,3,-2,-200.0,JAN_CD
4562344390378,1,3,-2,-200.0,JAN_CD
4902901487187,1,3,-2,-200.0,JAN_CD
4570025858598,1,3,-2,-200.0,JAN_CD
4953103281479,1,3,-2,-200.0,JAN_CD
4953103281271,1,3,-2,-200.0,JAN_CD
4582269541464,1,3,-2,-200.0,JAN_CD
4950654048155,1,3,-2,-200.0,JAN_CD
4589862983066,1,3,-2,-200.0,JAN_CD
4589863006672,1,3,-2,-200.0,JAN_CD
4901087006458,2,6,-4,-200.0,JAN_CD
4901087160396,2,6,-4,-200.0,JAN_CD
4582269541181,1,3,-2,-200.0,JAN_CD
4901087188291,3,9,-6,-200.0,JAN_CD
4901087196296,1,3,-2,-200.0,JAN_CD
4907990302700,1,3,-2,-200.0,JAN_CD
4901087217199,1,3,-2,-200.0,JAN_CD
4901087224227,3,9,-6,-200.0,JAN_CD
4906186510332,1,3,-2,-200.0,JAN_CD
4905524850543,1,3,-2,-200.0,JAN_CD
4902901922954,1,3,-2,-200.0,JAN_CD
4902704302441,2,6,-4,-200.0,JAN_CD
4930393988943,1,3,-2,-200.0,JAN_CD
4562451404463,1,3,-2,-200.0,JAN_CD
4953103294530,1,3,-2,-200.0,JAN_CD
4953103462434,1,3,-2,-200.0,JAN_CD
3045386381531,1,3,-2,-200.0,JAN_CD
4571411195082,1,3,-2,-200.0,JAN_CD
4975769282355,1,3,-2,-200.0,JAN_CD
4975769000478,1,3,-2,-200.0,JAN_CD
4975501673168,1,3,-2,-200.0,JAN_CD
4571411200144,1,3,-2,-200.0,JAN_CD
4975479425240,1,3,-2,-200.0,JAN_CD
4971850983880,1,3,-2,-200.0,JAN_CD
4953103457164,1,3,-2,-200.0,JAN_CD
4573198820133,1,3,-2,-200.0,JAN_CD
4580256070461,1,3,-2,-200.0,JAN_CD
4967576646444,1,3,-2,-200.0,JAN_CD
4967576411479,1,3,-2,-200.0,JAN_CD
4580548419084,1,3,-2,-200.0,JAN_CD
4960999577388,1,3,-2,-200.0,JAN_CD
4953103497313,1,3,-2,-200.0,JAN_CD
4953103462465,1,3,-2,-200.0,JAN_CD
4582269537801,1,3,-2,-200.0,JAN_CD
4971275605879,3,9,-6,-200.0,JAN_CD
4971275617605,1,3,-2,-200.0,JAN_CD
4902201428965,1,3,-2,-200.0,JAN_CD
4547410455229,1,3,-2,-200.0,JAN_CD
4518707298904,1,3,-2,-200.0,JAN_CD
4549550139175,1,3,-2,-200.0,JAN_CD
4548736133983,1,3,-2,-200.0,JAN_CD
4518707298799,1,3,-2,-200.0,JAN_CD
4518707300867,4,12,-8,-200.0,JAN_CD
4549077899040,6,18,-12,-200.0,JAN_CD
4549550155267,1,3,-2,-200.0,JAN_CD
4518707288394,1,3,-2,-200.0,JAN_CD
4549292100068,1,3,-2,-200.0,JAN_CD
4518707300843,2,6,-4,-200.0,JAN_CD
4549292185362,1,3,-2,-200.0,JAN_CD
4547410449341,2,6,-4,-200.0,JAN_CD
4549526805998,1,3,-2,-200.0,JAN_CD
4549550183253,1,3,-2,-200.0,JAN_CD
4549550175586,1,3,-2,-200.0,JAN_CD
4547410370003,1,3,-2,-200.0,JAN_CD
4549077898968,16,46,-30,-187.5,JAN_CD
4547441382211,6,17,-11,-183.33,JAN_CD
4902901932120,4,11,-7,-175.0,JAN_CD
4967576568043,10,27,-17,-170.0,JAN_CD
4988075701212,3,8,-5,-166.67,JAN_CD
4984824364127,15,40,-25,-166.67,JAN_CD
4967576300261,8,21,-13,-162.5,JAN_CD
4957792430767,5,13,-8,-160.0,JAN_CD
4549077890931,4,10,-6,-150.0,JAN_CD
4549550143936,2,5,-3,-150.0,JAN_CD
4571411196027,4,10,-6,-150.0,JAN_CD
4549550148696,2,5,-3,-150.0,JAN_CD
4549980522929,2,5,-3,-150.0,JAN_CD
4549980522875,2,5,-3,-150.0,JAN_CD
4975584505660,2,5,-3,-150.0,JAN_CD
4988075701229,2,5,-3,-150.0,JAN_CD
4988075703865,2,5,-3,-150.0,JAN_CD
4549980592281,2,5,-3,-150.0,JAN_CD
4904530062193,2,5,-3,-150.0,JAN_CD
4984824434127,2,5,-3,-150.0,JAN_CD
4518707301413,2,5,-3,-150.0,JAN_CD
4548736133938,2,5,-3,-150.0,JAN_CD
4960999484082,2,5,-3,-150.0,JAN_CD
4548736062344,2,5,-3,-150.0,JAN_CD
4549980668313,2,5,-3,-150.0,JAN_CD
4902901777028,5,12,-7,-140.0,JAN_CD
4549292144949,6,14,-8,-133.33,JAN_CD
4549980652954,3,7,-4,-133.33,JAN_CD
4974019828763,3,7,-4,-133.33,JAN_CD
4549980591420,4,9,-5,-125.0,JAN_CD
4518707300904,4,9,-5,-125.0,JAN_CD
4549980591796,4,9,-5,-125.0,JAN_CD
4957792011577,4,9,-5,-125.0,JAN_CD
4967576568036,13,28,-15,-115.38,JAN_CD
4984824817067,7,15,-8,-114.29,JAN_CD
4988075692954,1,2,-1,-100.0,JAN_CD
4988075692237,1,2,-1,-100.0,JAN_CD
4549550130714,1,2,-1,-100.0,JAN_CD
4580625138600,1,2,-1,-100.0,JAN_CD
4580625138792,2,4,-2,-100.0,JAN_CD
4580625137238,1,2,-1,-100.0,JAN_CD
4580625138495,1,2,-1,-100.0,JAN_CD
4988075672215,1,2,-1,-100.0,JAN_CD
4549550126113,1,2,-1,-100.0,JAN_CD
4582269539904,1,2,-1,-100.0,JAN_CD
4549550175562,1,2,-1,-100.0,JAN_CD
4984824733756,5,10,-5,-100.0,JAN_CD
4988075693821,1,2,-1,-100.0,JAN_CD
4582269541990,1,2,-1,-100.0,JAN_CD
4582269544953,1,2,-1,-100.0,JAN_CD
4549550107761,1,2,-1,-100.0,JAN_CD
4582521680054,2,4,-2,-100.0,JAN_CD
4549550102520,1,2,-1,-100.0,JAN_CD
4988075694392,1,2,-1,-100.0,JAN_CD
4549980606674,1,2,-1,-100.0,JAN_CD
4897098687963,1,2,-1,-100.0,JAN_CD
4582116754306,1,2,-1,-100.0,JAN_CD
4984824733848,10,20,-10,-100.0,JAN_CD
4984824817012,3,6,-3,-100.0,JAN_CD
4580548440170,1,2,-1,-100.0,JAN_CD
4549550156592,1,2,-1,-100.0,JAN_CD
4549550156615,1,2,-1,-100.0,JAN_CD
4988075666115,1,2,-1,-100.0,JAN_CD
4570025872587,1,2,-1,-100.0,JAN_CD
4562451402186,1,2,-1,-100.0,JAN_CD
4562451400816,1,2,-1,-100.0,JAN_CD
4987176163011,1,2,-1,-100.0,JAN_CD
4985115970522,1,2,-1,-100.0,JAN_CD
4573491409776,1,2,-1,-100.0,JAN_CD
4562451400809,1,2,-1,-100.0,JAN_CD
4549550142953,2,4,-2,-100.0,JAN_CD
4580548442228,1,2,-1,-100.0,JAN_CD
4984824505278,1,2,-1,-100.0,JAN_CD
4562358095887,1,2,-1,-100.0,JAN_CD
4522327907108,1,2,-1,-100.0,JAN_CD
4549550137201,1,2,-1,-100.0,JAN_CD
4549550137034,1,2,-1,-100.0,JAN_CD
4562344390361,1,2,-1,-100.0,JAN_CD
4562344390101,1,2,-1,-100.0,JAN_CD
4580548416342,1,2,-1,-100.0,JAN_CD
4580548418490,1,2,-1,-100.0,JAN_CD
4988075670884,1,2,-1,-100.0,JAN_CD
4988075689305,1,2,-1,-100.0,JAN_CD
4580548419411,1,2,-1,-100.0,JAN_CD
4984824869462,10,20,-10,-100.0,JAN_CD
4549550142113,1,2,-1,-100.0,JAN_CD
4984824101173,1,2,-1,-100.0,JAN_CD
4901087160402,2,4,-2,-100.0,JAN_CD
4953103827073,1,2,-1,-100.0,JAN_CD
4971275780118,1,2,-1,-100.0,JAN_CD
4953103468665,1,2,-1,-100.0,JAN_CD
4549077630834,1,2,-1,-100.0,JAN_CD
4971850145202,3,6,-3,-100.0,JAN_CD
4953103431119,1,2,-1,-100.0,JAN_CD
4549077631220,1,2,-1,-100.0,JAN_CD
4953103373266,1,2,-1,-100.0,JAN_CD
4953103372559,1,2,-1,-100.0,JAN_CD
4953103355729,1,2,-1,-100.0,JAN_CD
4953103353404,1,2,-1,-100.0,JAN_CD
4971850983934,1,2,-1,-100.0,JAN_CD
4953103321595,1,2,-1,-100.0,JAN_CD
4953103318823,1,2,-1,-100.0,JAN_CD
4953103264670,1,2,-1,-100.0,JAN_CD
4953103846371,1,2,-1,-100.0,JAN_CD
4953103259690,1,2,-1,-100.0,JAN_CD
4953103875388,1,2,-1,-100.0,JAN_CD
4961672482203,1,2,-1,-100.0,JAN_CD
4969887832097,1,2,-1,-100.0,JAN_CD
4969887691731,1,2,-1,-100.0,JAN_CD
4969887836316,1,2,-1,-100.0,JAN_CD
4547410426663,1,2,-1,-100.0,JAN_CD
4968291312867,1,2,-1,-100.0,JAN_CD
4967576648240,1,2,-1,-100.0,JAN_CD
4969887836514,1,2,-1,-100.0,JAN_CD
4548736037014,1,2,-1,-100.0,JAN_CD
4969887837580,1,2,-1,-100.0,JAN_CD
4967576568074,32,64,-32,-100.0,JAN_CD
4971275015999,1,2,-1,-100.0,JAN_CD
4548736062108,1,2,-1,-100.0,JAN_CD
4967576300544,5,10,-5,-100.0,JAN_CD
4966307308873,3,6,-3,-100.0,JAN_CD
4966307301737,5,10,-5,-100.0,JAN_CD
4959237512663,1,2,-1,-100.0,JAN_CD
4953103239043,1,2,-1,-100.0,JAN_CD
4974305222183,1,2,-1,-100.0,JAN_CD
4975302420114,1,2,-1,-100.0,JAN_CD
4549292185072,1,2,-1,-100.0,JAN_CD
4902704240644,6,12,-6,-100.0,JAN_CD
4979969011623,2,4,-2,-100.0,JAN_CD
4902580188566,1,2,-1,-100.0,JAN_CD
4902580187347,2,4,-2,-100.0,JAN_CD
4902530814026,1,2,-1,-100.0,JAN_CD
4902530515312,2,4,-2,-100.0,JAN_CD
4984279130506,1,2,-1,-100.0,JAN_CD
4988075694682,1,2,-1,-100.0,JAN_CD
4901087218103,1,2,-1,-100.0,JAN_CD
4901087215256,1,2,-1,-100.0,JAN_CD
4522327945162,1,2,-1,-100.0,JAN_CD
4901087208906,1,2,-1,-100.0,JAN_CD
4901087204496,1,2,-1,-100.0,JAN_CD
4901087196173,1,2,-1,-100.0,JAN_CD
4902704778833,1,2,-1,-100.0,JAN_CD
4978877204172,1,2,-1,-100.0,JAN_CD
4902901776991,1,2,-1,-100.0,JAN_CD
4903456191932,2,4,-2,-100.0,JAN_CD
4975302420121,1,2,-1,-100.0,JAN_CD
4975479175459,1,2,-1,-100.0,JAN_CD
4943765047988,1,2,-1,-100.0,JAN_CD
4942322015354,1,2,-1,-100.0,JAN_CD
4938650400122,1,2,-1,-100.0,JAN_CD
4932883624539,1,2,-1,-100.0,JAN_CD
4932883624515,1,2,-1,-100.0,JAN_CD
4984824410862,10,20,-10,-100.0,JAN_CD
4907986024104,1,2,-1,-100.0,JAN_CD
4906186286916,1,2,-1,-100.0,JAN_CD
4905009708277,1,2,-1,-100.0,JAN_CD
4904323403530,2,4,-2,-100.0,JAN_CD
4523608027171,4,8,-4,-100.0,JAN_CD
4549292004533,1,2,-1,-100.0,JAN_CD
4903456215874,1,2,-1,-100.0,JAN_CD
4549292004540,1,2,-1,-100.0,JAN_CD
4906186722308,1,2,-1,-100.0,JAN_CD
4988075695627,1,2,-1,-100.0,JAN_CD
4549550200592,1,2,-1,-100.0,JAN_CD
4984824335745,5,10,-5,-100.0,JAN_CD
4516023778889,1,2,-1,-100.0,JAN_CD
4988617361355,1,2,-1,-100.0,JAN_CD
4549980595053,1,2,-1,-100.0,JAN_CD
4988075696938,1,2,-1,-100.0,JAN_CD
4549980595008,3,6,-3,-100.0,JAN_CD
4549550251013,1,2,-1,-100.0,JAN_CD
4549550251686,1,2,-1,-100.0,JAN_CD
4549550256032,1,2,-1,-100.0,JAN_CD
4988617330979,1,2,-1,-100.0,JAN_CD
4549550258494,1,2,-1,-100.0,JAN_CD
4549550258784,1,2,-1,-100.0,JAN_CD
4518707300850,3,6,-3,-100.0,JAN_CD
4549550183451,1,2,-1,-100.0,JAN_CD
4549550264457,1,2,-1,-100.0,JAN_CD
4549550269070,1,2,-1,-100.0,JAN_CD
4988617254664,4,8,-4,-100.0,JAN_CD
4549550271189,1,2,-1,-100.0,JAN_CD
4988075699748,1,2,-1,-100.0,JAN_CD
4549980591963,1,2,-1,-100.0,JAN_CD
4988075700482,1,2,-1,-100.0,JAN_CD
4549550272421,1,2,-1,-100.0,JAN_CD
4988617228467,1,2,-1,-100.0,JAN_CD
4549980034538,1,2,-1,-100.0,JAN_CD
4549980048375,1,2,-1,-100.0,JAN_CD
4988617017511,1,2,-1,-100.0,JAN_CD
4549980550366,1,2,-1,-100.0,JAN_CD
4988075705586,1,2,-1,-100.0,JAN_CD
4988075696174,1,2,-1,-100.0,JAN_CD
4549550187442,1,2,-1,-100.0,JAN_CD
4549980490822,1,2,-1,-100.0,JAN_CD
4549550215558,1,2,-1,-100.0,JAN_CD
4549550230438,1,2,-1,-100.0,JAN_CD
4549550215176,1,2,-1,-100.0,JAN_CD
4549550193108,1,2,-1,-100.0,JAN_CD
4511677132377,2,4,-2,-100.0,JAN_CD
4549550210270,1,2,-1,-100.0,JAN_CD
4971850467533,19,35,-16,-84.21,JAN_CD
4902901932090,12,22,-10,-83.33,JAN_CD
4549077898982,18,33,-15,-83.33,JAN_CD
4984824815711,33,60,-27,-81.82,JAN_CD
4991348064297,5,9,-4,-80.0,JAN_CD
4549980593288,5,9,-4,-80.0,JAN_CD
4969887836453,5,9,-4,-80.0,JAN_CD
4902901932236,8,14,-6,-75.0,JAN_CD
4901087004478,4,7,-3,-75.0,JAN_CD
4549077602282,7,12,-5,-71.43,JAN_CD
4968291311693,3,5,-2,-66.67,JAN_CD
4967576568142,3,5,-2,-66.67,JAN_CD
4549980592304,3,5,-2,-66.67,JAN_CD
4549550143905,3,5,-2,-66.67,JAN_CD
4549980591741,3,5,-2,-66.67,JAN_CD
4904530022791,3,5,-2,-66.67,JAN_CD
4961672482302,3,5,-2,-66.67,JAN_CD
4582269540771,3,5,-2,-66.67,JAN_CD
4971850071471,3,5,-2,-66.67,JAN_CD
4901087021970,3,5,-2,-66.67,JAN_CD
4549550175982,3,5,-2,-66.67,JAN_CD
4549550242752,3,5,-2,-66.67,JAN_CD
4902901932274,36,58,-22,-61.11,JAN_CD
4549980592786,5,8,-3,-60.0,JAN_CD
4549980594858,5,8,-3,-60.0,JAN_CD
4984824720046,7,11,-4,-57.14,JAN_CD
4907986022032,17,26,-9,-52.94,JAN_CD
4549980595794,2,3,-1,-50.0,JAN_CD
4549550126106,2,3,-1,-50.0,JAN_CD
4903456188277,2,3,-1,-50.0,JAN_CD
4549292094886,2,3,-1,-50.0,JAN_CD
4580060592593,2,3,-1,-50.0,JAN_CD
4549550183352,2,3,-1,-50.0,JAN_CD
4580625137276,2,3,-1,-50.0,JAN_CD
4549980596401,2,3,-1,-50.0,JAN_CD
4549550175715,2,3,-1,-50.0,JAN_CD
4518707276018,2,3,-1,-50.0,JAN_CD
4549292144567,8,12,-4,-50.0,JAN_CD
4549550103121,2,3,-1,-50.0,JAN_CD
4969887698211,2,3,-1,-50.0,JAN_CD
4902580757915,2,3,-1,-50.0,JAN_CD
4902580517809,2,3,-1,-50.0,JAN_CD
4901087190461,8,12,-4,-50.0,JAN_CD
4902580507688,2,3,-1,-50.0,JAN_CD
4580256088572,2,3,-1,-50.0,JAN_CD
4984824829091,2,3,-1,-50.0,JAN_CD
4549292185249,2,3,-1,-50.0,JAN_CD
4549550268561,2,3,-1,-50.0,JAN_CD
4988075694668,2,3,-1,-50.0,JAN_CD
4904550372715,4,6,-2,-50.0,JAN_CD
4549550175647,2,3,-1,-50.0,JAN_CD
4548736101159,2,3,-1,-50.0,JAN_CD
4549550187374,2,3,-1,-50.0,JAN_CD
4549550156653,2,3,-1,-50.0,JAN_CD
4991348061418,2,3,-1,-50.0,JAN_CD
4953103355200,2,3,-1,-50.0,JAN_CD
4966307301744,4,6,-2,-50.0,JAN_CD
4930393988950,2,3,-1,-50.0,JAN_CD
4971850983927,2,3,-1,-50.0,JAN_CD
4549550258838,2,3,-1,-50.0,JAN_CD
4953103253407,2,3,-1,-50.0,JAN_CD
4971275055391,2,3,-1,-50.0,JAN_CD
4549550184960,2,3,-1,-50.0,JAN_CD
4549550183529,2,3,-1,-50.0,JAN_CD
4988075685758,4,6,-2,-50.0,JAN_CD
4988075697232,2,3,-1,-50.0,JAN_CD
4971850505532,2,3,-1,-50.0,JAN_CD
4967576648226,2,3,-1,-50.0,JAN_CD
4960999577449,2,3,-1,-50.0,JAN_CD
4988617361386,2,3,-1,-50.0,JAN_CD
4549550236225,2,3,-1,-50.0,JAN_CD
4977766701839,4,6,-2,-50.0,JAN_CD
4582269530192,2,3,-1,-50.0,JAN_CD
4549077899064,33,48,-15,-45.45,JAN_CD
4549980595565,7,10,-3,-42.86,JAN_CD
4549980591475,7,10,-3,-42.86,JAN_CD
4988075685628,7,10,-3,-42.86,JAN_CD
4549980704622,12,17,-5,-41.67,JAN_CD
4984824817050,5,7,-2,-40.0,JAN_CD
4902901932229,8,11,-3,-37.5,JAN_CD
4549980593301,11,15,-4,-36.36,JAN_CD
4971850929925,3,4,-1,-33.33,JAN_CD
4957792436813,3,4,-1,-33.33,JAN_CD
4984824376519,12,16,-4,-33.33,JAN_CD
4549980012734,3,4,-1,-33.33,JAN_CD
4210201416784,3,4,-1,-33.33,JAN_CD
4549526329180,3,4,-1,-33.33,JAN_CD
4547441382402,3,4,-1,-33.33,JAN_CD
4901087217038,3,4,-1,-33.33,JAN_CD
4969887698204,6,8,-2,-33.33,JAN_CD
4902901777073,6,8,-2,-33.33,JAN_CD
4905009427352,3,4,-1,-33.33,JAN_CD
4549077898999,21,28,-7,-33.33,JAN_CD
4984824335707,9,12,-3,-33.33,JAN_CD
4975302549013,3,4,-1,-33.33,JAN_CD
4988617304239,3,4,-1,-33.33,JAN_CD
4975302525024,3,4,-1,-33.33,JAN_CD
4967576248501,6,8,-2,-33.33,JAN_CD
4571411198847,3,4,-1,-33.33,JAN_CD
4549292003765,3,4,-1,-33.33,JAN_CD
4522327945124,3,4,-1,-33.33,JAN_CD
4981747078070,3,4,-1,-33.33,JAN_CD
4902901932106,6,8,-2,-33.33,JAN_CD
4966307301782,10,13,-3,-30.0,JAN_CD
4549980592434,7,9,-2,-28.57,JAN_CD
4902580517502,7,9,-2,-28.57,JAN_CD
4549980443408,11,14,-3,-27.27,JAN_CD
4549077898524,15,19,-4,-26.67,JAN_CD
4901087179602,4,5,-1,-25.0,JAN_CD
4974019221670,4,5,-1,-25.0,JAN_CD
4549550199063,4,5,-1,-25.0,JAN_CD
4904530027222,4,5,-1,-25.0,JAN_CD
4549550175883,4,5,-1,-25.0,JAN_CD
4549550175876,4,5,-1,-25.0,JAN_CD
4580625137221,4,5,-1,-25.0,JAN_CD
4549077898517,9,11,-2,-22.22,JAN_CD
4984824733749,5,6,-1,-20.0,JAN_CD
4904530027208,5,6,-1,-20.0,JAN_CD
4549980595275,5,6,-1,-20.0,JAN_CD
4562344390323,5,6,-1,-20.0,JAN_CD
4901087191567,5,6,-1,-20.0,JAN_CD
4901087187263,5,6,-1,-20.0,JAN_CD
4549077899002,28,33,-5,-17.86,JAN_CD
4901087216963,6,7,-1,-16.67,JAN_CD
4549077899057,67,78,-11,-16.42,JAN_CD
4901087190225,19,22,-3,-15.79,JAN_CD
4548736144866,7,8,-1,-14.29,JAN_CD
4549980592427,8,9,-1,-12.5,JAN_CD
4953103319271,9,10,-1,-11.11,JAN_CD
4966307301775,20,22,-2,-10.0,JAN_CD
4549077898951,44,48,-4,-9.09,JAN_CD
4976861330029,439,459,-20,-4.56,JAN_CD
