TITLE,SGY_JSK_QTY_2023-04-15,SGY_JSK_QTY_2023-03-15,CHANGE_AMOUNT,CHANGE(%),CATEGORY
PM-P222FLGGBL,5,223,-218,-4360.0,KATAMEI
TVｼﾕｳﾍﾝｷｷｻﾎﾟ-ﾄIDAﾄﾞｳｺﾝ1Y,1,41,-40,-4000.0,KATAMEI
A1291011,1,40,-39,-3900.0,KATAMEI
AMFIAL200CMK-SV,3,93,-90,-3000.0,KATAMEI
4648034,1,29,-28,-2800.0,KATAMEI
PM-X224FLGG,1,28,-27,-2700.0,KATAMEI
DRM0032,1,26,-25,-2500.0,KATAMEI
EW09104C-W,1,22,-21,-2100.0,KATAMEI
PM-P222FLGG,4,81,-77,-1925.0,KATAMEI
SQ762W,2,40,-38,-1900.0,KATAMEI
GE3494IP261,1,19,-18,-1800.0,KATAMEI
41-945087,1,18,-17,-1700.0,KATAMEI
41-945049,1,18,-17,-1700.0,KATAMEI
INSTAXMINIJP2,9,155,-146,-1622.22,KATAMEI
PM-F212FLGG,2,34,-32,-1600.0,KATAMEI
SL-013BK,5,83,-78,-1560.0,KATAMEI
KO1711JP,3,49,-46,-1533.33,KATAMEI
EDW012,3,45,-42,-1400.0,KATAMEI
A2633NQ9,1,14,-13,-1300.0,KATAMEI
A2147N21,1,14,-13,-1300.0,KATAMEI
GP3649PXL6A,1,14,-13,-1300.0,KATAMEI
AR-AP50-BR-E2,1,14,-13,-1300.0,KATAMEI
TR-IP22M2-CGC-CCCL,1,12,-11,-1100.0,KATAMEI
N-W1A,1,12,-11,-1100.0,KATAMEI
TK-FBM112BK,1,12,-11,-1100.0,KATAMEI
U3HC-A429BXWF,1,12,-11,-1100.0,KATAMEI
G240F,1,11,-10,-1000.0,KATAMEI
WH2122WP,1,11,-10,-1000.0,KATAMEI
GST3413XP104,1,10,-9,-900.0,KATAMEI
AR-A50-WG-E2,1,10,-9,-900.0,KATAMEI
LR44P,1,10,-9,-900.0,KATAMEI
LR20EM/4S,1,10,-9,-900.0,KATAMEI
SL-002AGR,1,10,-9,-900.0,KATAMEI
FHD100ECWLCF3,2,19,-17,-850.0,KATAMEI
EW-DJ55-W,2,19,-17,-850.0,KATAMEI
A2027N21,1,9,-8,-800.0,KATAMEI
TAP134UW,1,9,-8,-800.0,KATAMEI
GL-101A420,1,9,-8,-800.0,KATAMEI
LDA14L-G-10EDA,2,18,-16,-800.0,KATAMEI
GL-101A450,1,9,-8,-800.0,KATAMEI
ｺ-ﾙﾏﾝ ｾﾙﾌｲ-ｽﾀﾝﾄﾞ(BK),1,9,-8,-800.0,KATAMEI
TR-IP22M2-TT-CL,1,9,-8,-800.0,KATAMEI
A1112N11,2,16,-14,-700.0,KATAMEI
TAP-TSH32N,1,8,-7,-700.0,KATAMEI
G3315IP247,1,8,-7,-700.0,KATAMEI
PM-X222FLGG,2,16,-14,-700.0,KATAMEI
GST3485IP261,1,8,-7,-700.0,KATAMEI
A80A1N31,1,8,-7,-700.0,KATAMEI
DRMLC902,3,24,-21,-700.0,KATAMEI
SCDP2W-P,1,8,-7,-700.0,KATAMEI
WP4,1,8,-7,-700.0,KATAMEI
RT-GP7CC2/CM,1,8,-7,-700.0,KATAMEI
TAP-TSH43N,1,8,-7,-700.0,KATAMEI
PM-X223FLF,2,15,-13,-650.0,KATAMEI
INSTAXMINIJP1,8,59,-51,-637.5,KATAMEI
TICE750W,1,7,-6,-600.0,KATAMEI
KL100SLU,1,7,-6,-600.0,KATAMEI
TAP-TSH31N,1,7,-6,-600.0,KATAMEI
LB-PS35L40C-2P,1,7,-6,-600.0,KATAMEI
TR-IP22M3-G3-B3CCBK,1,7,-6,-600.0,KATAMEI
MDREX155LI,1,7,-6,-600.0,KATAMEI
CHW601E1,1,7,-6,-600.0,KATAMEI
EDLTL40-LED-28N,2,14,-12,-600.0,KATAMEI
GL-101L100,2,13,-11,-550.0,KATAMEI
ECI-C310B-V,18,113,-95,-527.78,KATAMEI
41-945971,1,6,-5,-500.0,KATAMEI
SCJ2LSW-P,1,6,-5,-500.0,KATAMEI
ES-RT19-A,1,6,-5,-500.0,KATAMEI
A2147NV1,1,6,-5,-500.0,KATAMEI
PM-A22AFLGGE,1,6,-5,-500.0,KATAMEI
G640S,1,6,-5,-500.0,KATAMEI
MUJ-EGK1.5M GM,1,6,-5,-500.0,KATAMEI
5BNR2VJPS4,1,6,-5,-500.0,KATAMEI
PM-A22CFLGGBL,1,6,-5,-500.0,KATAMEI
LRｰ44/2P,5,30,-25,-500.0,KATAMEI
PM-A22AFLLG,1,6,-5,-500.0,KATAMEI
DLC-HJ20B,1,6,-5,-500.0,KATAMEI
LR14EM/4S,2,12,-10,-500.0,KATAMEI
LDA8L-G/60V1,1,6,-5,-500.0,KATAMEI
LDA4LHE17ESW2,1,6,-5,-500.0,KATAMEI
LAM-FA3203,1,6,-5,-500.0,KATAMEI
SCL-75LMS-LGP,1,6,-5,-500.0,KATAMEI
CAC-HDMIVGA10BK,1,6,-5,-500.0,KATAMEI
CD-31ECO,1,6,-5,-500.0,KATAMEI
KBPPCZ3,1,6,-5,-500.0,KATAMEI
SH412ST,2,12,-10,-500.0,KATAMEI
IN-SN13NV,1,6,-5,-500.0,KATAMEI
P351722C,1,6,-5,-500.0,KATAMEI
B2149N21,1,6,-5,-500.0,KATAMEI
SCL12DMS-TH,1,6,-5,-500.0,KATAMEI
EW-DJ75-W,1,6,-5,-500.0,KATAMEI
ES-LT2B-K,3,17,-14,-466.67,KATAMEI
PM-A19CFLFPBLR,2,11,-9,-450.0,KATAMEI
SD201L100,2,11,-9,-450.0,KATAMEI
SL-002AB,3,16,-13,-433.33,KATAMEI
LR03AN 4BP,7,36,-29,-414.29,KATAMEI
TR-IP22M2-G3-GOCCBK,1,5,-4,-400.0,KATAMEI
OWL-ADCMFM-RE,1,5,-4,-400.0,KATAMEI
NT-18UBK,1,5,-4,-400.0,KATAMEI
SE-BE00A,1,5,-4,-400.0,KATAMEI
SL-013GR,4,20,-16,-400.0,KATAMEI
M550MOW,1,5,-4,-400.0,KATAMEI
M-DY10DRSKPN,1,5,-4,-400.0,KATAMEI
LR14FH(4S),1,5,-4,-400.0,KATAMEI
LDA5L-G-4EDA,4,20,-16,-400.0,KATAMEI
TAP-TSH33N,1,5,-4,-400.0,KATAMEI
TB-A21PMFLGG,1,5,-4,-400.0,KATAMEI
FPL27EXNCF3,2,10,-8,-400.0,KATAMEI
TR-IP22M2-GR-CLBK,2,10,-8,-400.0,KATAMEI
IN-CA13BK,1,5,-4,-400.0,KATAMEI
100-92200901-40,2,10,-8,-400.0,KATAMEI
A-ONE.51291,1,5,-4,-400.0,KATAMEI
A8662N12,2,10,-8,-400.0,KATAMEI
A-360SBW,2,10,-8,-400.0,KATAMEI
A3125N11,2,10,-8,-400.0,KATAMEI
A8012N12,2,9,-7,-350.0,KATAMEI
7083IP261TP,2,9,-7,-350.0,KATAMEI
JBT-401CRW,2,9,-7,-350.0,KATAMEI
VL-SWZ200KL,2,9,-7,-350.0,KATAMEI
GL-1012L50,2,9,-7,-350.0,KATAMEI
LR03XJSP/14S,10,44,-34,-340.0,KATAMEI
8RZ166SR03,13,57,-44,-338.46,KATAMEI
WC-AG15PN,16,70,-54,-337.5,KATAMEI
CR1632EM/1BP,3,13,-10,-333.33,KATAMEI
M550LGR,1,4,-3,-300.0,KATAMEI
SL-002AW,1,4,-3,-300.0,KATAMEI
M-Y9UBXWH,1,4,-3,-300.0,KATAMEI
LS4366,1,4,-3,-300.0,KATAMEI
6675ARWEHB,1,4,-3,-300.0,KATAMEI
SR1130P,1,4,-3,-300.0,KATAMEI
VSI-1031/PJ,1,4,-3,-300.0,KATAMEI
SD-MIX100A,1,4,-3,-300.0,KATAMEI
LR14NJ/2SE,1,4,-3,-300.0,KATAMEI
MCAA2001BR,1,4,-3,-300.0,KATAMEI
GP3706PXL7,2,8,-6,-300.0,KATAMEI
ED-CCYS20BK,1,4,-3,-300.0,KATAMEI
LM-125,1,4,-3,-300.0,KATAMEI
LDT1YR-G-E12-G10013P,1,4,-3,-300.0,KATAMEI
6960XP104BO,1,4,-3,-300.0,KATAMEI
LDA4N-G-E17-4T5,1,4,-3,-300.0,KATAMEI
LC3119BK,1,4,-3,-300.0,KATAMEI
G3150AQOS6,1,4,-3,-300.0,KATAMEI
USB-2TCH23SN,1,4,-3,-300.0,KATAMEI
7081IP261TR,1,4,-3,-300.0,KATAMEI
G3405XP104,1,4,-3,-300.0,KATAMEI
USB-3TCH21SN,1,4,-3,-300.0,KATAMEI
JKIQ2400EDWH,1,4,-3,-300.0,KATAMEI
GI30PGBK,1,4,-3,-300.0,KATAMEI
GWP-10A224WT,1,4,-3,-300.0,KATAMEI
GST3483IP261,1,4,-3,-300.0,KATAMEI
TQ-479-8JF,1,4,-3,-300.0,KATAMEI
BCI-330XLPGBK,2,8,-6,-300.0,KATAMEI
LDC3L-G-E17-FC,1,4,-3,-300.0,KATAMEI
MPA-AC15NWH,1,4,-3,-300.0,KATAMEI
AXW22A-6RU0,2,8,-6,-300.0,KATAMEI
RTWS05BK,2,8,-6,-300.0,KATAMEI
PKB7MSB,1,4,-3,-300.0,KATAMEI
FDL18EXNCF3,1,4,-3,-300.0,KATAMEI
MPA-AC01NBK,1,4,-3,-300.0,KATAMEI
TSC212LC15K,1,4,-3,-300.0,KATAMEI
FCL30.32EDF-SHG-A2,1,4,-3,-300.0,KATAMEI
EW0983-X,1,4,-3,-300.0,KATAMEI
ES-RL15-A,2,8,-6,-300.0,KATAMEI
PR80PC10S4,1,4,-3,-300.0,KATAMEI
AP7W(W)-P,1,4,-3,-300.0,KATAMEI
QB-082CWH,1,4,-3,-300.0,KATAMEI
QB-082DEDBK,1,4,-3,-300.0,KATAMEI
R20CAAC3A03WH,1,4,-3,-300.0,KATAMEI
REG-04PK,1,4,-3,-300.0,KATAMEI
41-945100,1,4,-3,-300.0,KATAMEI
FFM-351-PRW,2,8,-6,-300.0,KATAMEI
M235NIW,1,4,-3,-300.0,KATAMEI
TR-IP22M3-G3-CCBK,1,4,-3,-300.0,KATAMEI
41-946312,1,4,-3,-300.0,KATAMEI
MPA-ACCP20WF,2,8,-6,-300.0,KATAMEI
41-946336,1,4,-3,-300.0,KATAMEI
FHC2734EL2CF32K,1,4,-3,-300.0,KATAMEI
LR6EM/24S,28,108,-80,-285.71,KATAMEI
LDA8L-G-6EDA2P,14,53,-39,-278.57,KATAMEI
LW100V38W-W,3,11,-8,-266.67,KATAMEI
ZP-2030-50,2,7,-5,-250.0,KATAMEI
LC100V60W55/2P,2,7,-5,-250.0,KATAMEI
EDMB01WH,2,7,-5,-250.0,KATAMEI
CICIW32SRM,2,7,-5,-250.0,KATAMEI
PM-A22AHVCKKCR,2,7,-5,-250.0,KATAMEI
M331RBK,2,7,-5,-250.0,KATAMEI
M-BL27UBSKBK,2,7,-5,-250.0,KATAMEI
UR-20N 5P,2,7,-5,-250.0,KATAMEI
SM-ZB36-VM,2,7,-5,-250.0,KATAMEI
LR03EM/24S,13,45,-32,-246.15,KATAMEI
SL-013NV,3,10,-7,-233.33,KATAMEI
LR20NJ/2B,3,10,-7,-233.33,KATAMEI
CR1220P,12,40,-28,-233.33,KATAMEI
REG-04WH,3,10,-7,-233.33,KATAMEI
SL-013WH,7,23,-16,-228.57,KATAMEI
LR03EM/4S,4,13,-9,-225.0,KATAMEI
LR03NJ/20SW,4,13,-9,-225.0,KATAMEI
LDA4L-G-E17-4T5,4,13,-9,-225.0,KATAMEI
GE3426XPA3,1,3,-2,-200.0,KATAMEI
FHD85ENWLCF3,1,3,-2,-200.0,KATAMEI
TY-SR66(K),1,3,-2,-200.0,KATAMEI
XD-SG5000BK,1,3,-2,-200.0,KATAMEI
EDCALCM01WH,1,3,-2,-200.0,KATAMEI
FIR-P19-5P,3,9,-6,-200.0,KATAMEI
TR-IP22M3-GL-B3CC,1,3,-2,-200.0,KATAMEI
A2323N21,1,3,-2,-200.0,KATAMEI
FL20SSECW18HCF32K,3,9,-6,-200.0,KATAMEI
G3366GA53,1,3,-2,-200.0,KATAMEI
EW-DL38-A,1,3,-2,-200.0,KATAMEI
TSC281L10L,1,3,-2,-200.0,KATAMEI
FSFSRR5112C-040A,1,3,-2,-200.0,KATAMEI
TSC245LT20W,1,3,-2,-200.0,KATAMEI
G2219BSO4,1,3,-2,-200.0,KATAMEI
TR-IP22M3-LCA-DRCCCC,1,3,-2,-200.0,KATAMEI
TSC149CA10K,4,12,-8,-200.0,KATAMEI
G-11H(W),2,6,-4,-200.0,KATAMEI
TR-IP224-G3-CCBK,1,3,-2,-200.0,KATAMEI
A2147N11,1,3,-2,-200.0,KATAMEI
TSC149CA05K,2,6,-4,-200.0,KATAMEI
KO6301JP,1,3,-2,-200.0,KATAMEI
TH181SB10K,1,3,-2,-200.0,KATAMEI
SCL12L-TH,1,3,-2,-200.0,KATAMEI
MPA-UALPS10SV,1,3,-2,-200.0,KATAMEI
MUG-Y,1,3,-2,-200.0,KATAMEI
NDGSHA01,1,3,-2,-200.0,KATAMEI
RT-RXP10M4CC2/CM,1,3,-2,-200.0,KATAMEI
PM-A19CTSLFCBK,1,3,-2,-200.0,KATAMEI
PM-A20BFLF,1,3,-2,-200.0,KATAMEI
PM-A22CFLLG,1,3,-2,-200.0,KATAMEI
RT-P27CC2/CM,1,3,-2,-200.0,KATAMEI
PM-A22SFLGFO,1,3,-2,-200.0,KATAMEI
RT-P24TBC1/BB,1,3,-2,-200.0,KATAMEI
PM-L104,1,3,-2,-200.0,KATAMEI
PM-P221FLGG,1,3,-2,-200.0,KATAMEI
PM-S221FLGGBL,1,3,-2,-200.0,KATAMEI
210337-0428RH,3,9,-6,-200.0,KATAMEI
PM-X222PLFYBK,1,3,-2,-200.0,KATAMEI
R01CAAC3A03WH,1,3,-2,-200.0,KATAMEI
RB8NC01,1,3,-2,-200.0,KATAMEI
RE-STV03(BK),1,3,-2,-200.0,KATAMEI
MPA-CCL02BK,1,3,-2,-200.0,KATAMEI
A-ONE.51033,1,3,-2,-200.0,KATAMEI
MPA-ACMAC155BK,1,3,-2,-200.0,KATAMEI
MP-9,1,3,-2,-200.0,KATAMEI
INSMINI40,2,6,-4,-200.0,KATAMEI
INSTAXMINIMIC2WW1,1,3,-2,-200.0,KATAMEI
INSTAXSQUAREWW2,1,3,-2,-200.0,KATAMEI
JNR-753BL-PL,1,3,-2,-200.0,KATAMEI
JNY-502HNZ,1,3,-2,-200.0,KATAMEI
KA4100SFR,1,3,-2,-200.0,KATAMEI
KA420PSKR,1,3,-2,-200.0,KATAMEI
7118IP261TP,1,3,-2,-200.0,KATAMEI
7091IP261HB,1,3,-2,-200.0,KATAMEI
LB-PS35L40W-2P,3,9,-6,-200.0,KATAMEI
LC-G-3MP,1,3,-2,-200.0,KATAMEI
LC100V100W60/2P,1,3,-2,-200.0,KATAMEI
T-K5A-2650WH,1,3,-2,-200.0,KATAMEI
LN-IM22VMFLGY,1,3,-2,-200.0,KATAMEI
LR110V25WS,2,6,-4,-200.0,KATAMEI
LR6NJ/4SE,6,18,-12,-200.0,KATAMEI
SNM-142D,1,3,-2,-200.0,KATAMEI
MAC-200RH,1,3,-2,-200.0,KATAMEI
MC170,1,3,-2,-200.0,KATAMEI
MPA-AC20NWH,1,3,-2,-200.0,KATAMEI
ECI-EMUG-4P,1,3,-2,-200.0,KATAMEI
RKF5SXA,1,3,-2,-200.0,KATAMEI
BCI-381S+380S6MP,1,3,-2,-200.0,KATAMEI
CAC-HD14E10BK2,1,3,-2,-200.0,KATAMEI
CAC-HD14E30BK2,1,3,-2,-200.0,KATAMEI
AKB-100(PK),2,6,-4,-200.0,KATAMEI
BCI-320PGBK,1,3,-2,-200.0,KATAMEI
VX-ML10G,1,3,-2,-200.0,KATAMEI
AR80FHP30SV7,1,3,-2,-200.0,KATAMEI
WI-C100 C,1,3,-2,-200.0,KATAMEI
DLC-HJ30B,1,3,-2,-200.0,KATAMEI
CVSSLBK,1,3,-2,-200.0,KATAMEI
EAS-6350T(H),1,3,-2,-200.0,KATAMEI
BCI-301M,1,3,-2,-200.0,KATAMEI
AP-119A,1,3,-2,-200.0,KATAMEI
VBE260NP10V1,1,3,-2,-200.0,KATAMEI
ANH3V-1600,1,3,-2,-200.0,KATAMEI
DQL-210J-7JF,1,3,-2,-200.0,KATAMEI
U3H-A416BF1WH,1,3,-2,-200.0,KATAMEI
CAC-HD14EY20BK,1,3,-2,-200.0,KATAMEI
LR03NJ/12SW,16,46,-30,-187.5,KATAMEI
WHA2513WKP,6,17,-11,-183.33,KATAMEI
CR2025EM/2BP,4,11,-7,-175.0,KATAMEI
LDA5L-G-4EDA2P,10,27,-17,-170.0,KATAMEI
CR-2032/2P,15,40,-25,-166.67,KATAMEI
CR3601IP2617,3,8,-5,-166.67,KATAMEI
LDA4N-G-4T5,8,21,-13,-162.5,KATAMEI
SW101A4,5,13,-8,-160.0,KATAMEI
FY-FST25,2,5,-3,-150.0,KATAMEI
EW-DL38-P,2,5,-3,-150.0,KATAMEI
MPA-ACC12WF,2,5,-3,-150.0,KATAMEI
MDREX155P,2,5,-3,-150.0,KATAMEI
4JW3FLS(B),2,5,-3,-150.0,KATAMEI
FL32SEXDF3,2,5,-3,-150.0,KATAMEI
WI-C100 L,2,5,-3,-150.0,KATAMEI
DMP-BD90-K,4,10,-6,-150.0,KATAMEI
WC-DP15PN4,2,5,-3,-150.0,KATAMEI
CR3602IP2617P,2,5,-3,-150.0,KATAMEI
A2663N21,4,10,-6,-150.0,KATAMEI
LDA7DHS6,2,5,-3,-150.0,KATAMEI
LDA7LHS6,2,5,-3,-150.0,KATAMEI
TSC212LC20W,2,5,-3,-150.0,KATAMEI
PR41V6P,2,5,-3,-150.0,KATAMEI
GL-101L400,2,5,-3,-150.0,KATAMEI
RAC2A2A04WH,2,5,-3,-150.0,KATAMEI
LR6EM/4S,5,12,-7,-140.0,KATAMEI
EH-NA0J-W,3,7,-4,-133.33,KATAMEI
FZ-E100MF,3,7,-4,-133.33,KATAMEI
BC361,6,14,-8,-133.33,KATAMEI
SW-201A4,4,9,-5,-125.0,KATAMEI
FL15ENWF3,4,9,-5,-125.0,KATAMEI
TSC149CA10W,4,9,-5,-125.0,KATAMEI
FHF32EXDHF3,4,9,-5,-125.0,KATAMEI
LDA4N-G-4EDA2P,13,28,-15,-115.38,KATAMEI
LR6EJV/4SE,7,15,-8,-114.29,KATAMEI
DE-C38-10000RD,1,2,-1,-100.0,KATAMEI
DE-C27-7000BK,1,2,-1,-100.0,KATAMEI
LR03XJV/8SW,10,20,-10,-100.0,KATAMEI
LR03EJSP/10S,10,20,-10,-100.0,KATAMEI
LR03(GD)10P,2,4,-2,-100.0,KATAMEI
VL-SWD505KF,1,2,-1,-100.0,KATAMEI
SRｰ916SW,1,2,-1,-100.0,KATAMEI
LDG11D-G/100V1,2,4,-2,-100.0,KATAMEI
LDA7D-G/60V1P,1,2,-1,-100.0,KATAMEI
LHP-05C5,1,2,-1,-100.0,KATAMEI
CAC-CHDMI20BK,1,2,-1,-100.0,KATAMEI
LDT1LE12C,1,2,-1,-100.0,KATAMEI
LDA7N-G-6EDA2P,32,64,-32,-100.0,KATAMEI
CTR-300,1,2,-1,-100.0,KATAMEI
LDS110V68WWK,1,2,-1,-100.0,KATAMEI
LDA7N-G-E17-6T5,5,10,-5,-100.0,KATAMEI
ECI-BR211B,1,2,-1,-100.0,KATAMEI
SW-KA30-HL,1,2,-1,-100.0,KATAMEI
TR-IP22L2-LCA-CCCC,1,2,-1,-100.0,KATAMEI
FL20SSEL18MF3,1,2,-1,-100.0,KATAMEI
LN-22WQ2VMFGY,1,2,-1,-100.0,KATAMEI
ECI-BR211C,1,2,-1,-100.0,KATAMEI
7023IP261BO,1,2,-1,-100.0,KATAMEI
LDA6D-G-E17S60V2,1,2,-1,-100.0,KATAMEI
INSTAXMINIMERMAIDTAILWW1,1,2,-1,-100.0,KATAMEI
GE3688AQOS7,1,2,-1,-100.0,KATAMEI
GH-DVP1HED-BK,2,4,-2,-100.0,KATAMEI
XKI-N20PGBK,1,2,-1,-100.0,KATAMEI
TB-A22RFLGG,1,2,-1,-100.0,KATAMEI
TB-AC10NBK,1,2,-1,-100.0,KATAMEI
IC6CL80M,4,8,-4,-100.0,KATAMEI
USB3-AFCMADBK,1,2,-1,-100.0,KATAMEI
CR-2W/2P,5,10,-5,-100.0,KATAMEI
IORBCB-6EL,1,2,-1,-100.0,KATAMEI
HV-LLPAD,1,2,-1,-100.0,KATAMEI
HS-TP41EDLP22,1,2,-1,-100.0,KATAMEI
HS-EP12BK,1,2,-1,-100.0,KATAMEI
TK-FCM103XBK,1,2,-1,-100.0,KATAMEI
H151R,1,2,-1,-100.0,KATAMEI
GW110V-40W/70,1,2,-1,-100.0,KATAMEI
GP-2000FS,1,2,-1,-100.0,KATAMEI
GST3528IP261P,1,2,-1,-100.0,KATAMEI
A-ONE.28691,1,2,-1,-100.0,KATAMEI
GST3297IP247,1,2,-1,-100.0,KATAMEI
HS100-2FB,1,2,-1,-100.0,KATAMEI
GE3373GA53,1,2,-1,-100.0,KATAMEI
IP20_61-VS04,1,2,-1,-100.0,KATAMEI
IQ-800J-1JF,1,2,-1,-100.0,KATAMEI
T-ADR3WH,1,2,-1,-100.0,KATAMEI
LD-GPAT/BU10,1,2,-1,-100.0,KATAMEI
T-KTR01WH,1,2,-1,-100.0,KATAMEI
6861IP247HB,1,2,-1,-100.0,KATAMEI
TAP-AC8W,1,2,-1,-100.0,KATAMEI
TAP-S15-1,1,2,-1,-100.0,KATAMEI
KX-FKD556-W,1,2,-1,-100.0,KATAMEI
TAP-TSH305N,1,2,-1,-100.0,KATAMEI
XR-12GWE,3,6,-3,-100.0,KATAMEI
72230,1,2,-1,-100.0,KATAMEI
KAM-Y,1,2,-1,-100.0,KATAMEI
TAP-TSH43SWN,1,2,-1,-100.0,KATAMEI
K2L20PSKR,1,2,-1,-100.0,KATAMEI
TB-08HPG3LBK,1,2,-1,-100.0,KATAMEI
CK-L08PK,1,2,-1,-100.0,KATAMEI
JNR-753MTB,1,2,-1,-100.0,KATAMEI
TB-A20MFLFAHD,1,2,-1,-100.0,KATAMEI
8RE677SR04,1,2,-1,-100.0,KATAMEI
JNL-356SMKKI,1,2,-1,-100.0,KATAMEI
ISC100W,1,2,-1,-100.0,KATAMEI
ISC100P,1,2,-1,-100.0,KATAMEI
LDA6D-H-E17S60V2,1,2,-1,-100.0,KATAMEI
VRG-M02RBK,1,2,-1,-100.0,KATAMEI
TR-XP224-GL-B3CC,1,2,-1,-100.0,KATAMEI
DH-EX4005,1,2,-1,-100.0,KATAMEI
PM-A22AHVCKCR,1,2,-1,-100.0,KATAMEI
41-907108,1,2,-1,-100.0,KATAMEI
PM-A20BFLGGEBL,1,2,-1,-100.0,KATAMEI
PM-A19CFLFPRN,2,4,-2,-100.0,KATAMEI
EHP-GB10MXBU,1,2,-1,-100.0,KATAMEI
EHP-LF10IMBBK,1,2,-1,-100.0,KATAMEI
RT-P40PFC2/BM,1,2,-1,-100.0,KATAMEI
PM-A19BHVCCR,1,2,-1,-100.0,KATAMEI
PKB7MXA,1,2,-1,-100.0,KATAMEI
PM-A22APLFYILNV,1,2,-1,-100.0,KATAMEI
WM-10,1,2,-1,-100.0,KATAMEI
ER-C68FL,1,2,-1,-100.0,KATAMEI
PGI1300M,1,2,-1,-100.0,KATAMEI
PG-IPTV01BK,1,2,-1,-100.0,KATAMEI
P351736F,5,10,-5,-100.0,KATAMEI
P351722F,3,6,-3,-100.0,KATAMEI
P-TPD02BK,1,2,-1,-100.0,KATAMEI
P-TPC02RD,1,2,-1,-100.0,KATAMEI
RT-RXPAM3CC2/CM,1,2,-1,-100.0,KATAMEI
ES9600,1,2,-1,-100.0,KATAMEI
PGI1300Y,1,2,-1,-100.0,KATAMEI
RT-P36ELC1/BR,1,2,-1,-100.0,KATAMEI
PM-A22CHVCKKCR,1,2,-1,-100.0,KATAMEI
ARCHERAX80,1,2,-1,-100.0,KATAMEI
RJK-30,2,4,-2,-100.0,KATAMEI
U2HC-A429BXBK,1,2,-1,-100.0,KATAMEI
RE-STA03(IV),1,2,-1,-100.0,KATAMEI
ECI-EKUIL-B,1,2,-1,-100.0,KATAMEI
RDH-C,1,2,-1,-100.0,KATAMEI
RDC2A2A01BK,1,2,-1,-100.0,KATAMEI
RC7-874D,1,2,-1,-100.0,KATAMEI
R20PNB/2VSE,10,20,-10,-100.0,KATAMEI
U2C-AMB10BK,1,2,-1,-100.0,KATAMEI
R01CAAC3A02WH,1,2,-1,-100.0,KATAMEI
PZ-790,2,4,-2,-100.0,KATAMEI
AD-ECOMT,1,2,-1,-100.0,KATAMEI
PP103A3K,1,2,-1,-100.0,KATAMEI
EDSTP01A,1,2,-1,-100.0,KATAMEI
EDSTP01C,1,2,-1,-100.0,KATAMEI
PM-X224FLGGBL,1,2,-1,-100.0,KATAMEI
20BNE1VJPS2,1,2,-1,-100.0,KATAMEI
RT-ARWCC2/CM,1,2,-1,-100.0,KATAMEI
EFD15ED11EE17F2,1,2,-1,-100.0,KATAMEI
PM-S226PLFUJPND,1,2,-1,-100.0,KATAMEI
RT-GA53ELC1/R,1,2,-1,-100.0,KATAMEI
P-STSR02WH,1,2,-1,-100.0,KATAMEI
LR20EJV/4SW,3,6,-3,-100.0,KATAMEI
P-SSBTRBK,1,2,-1,-100.0,KATAMEI
OWL-BTEP07S-RG,1,2,-1,-100.0,KATAMEI
4RL434-008,2,4,-2,-100.0,KATAMEI
MA-WBL32R,1,2,-1,-100.0,KATAMEI
M-Y9UBXBK,1,2,-1,-100.0,KATAMEI
M-DY12DBXBU,1,2,-1,-100.0,KATAMEI
5377BSO4BO,1,2,-1,-100.0,KATAMEI
W-QA16WF,1,2,-1,-100.0,KATAMEI
TR-XP225-GLS-CC,1,2,-1,-100.0,KATAMEI
LZ-IC100,1,2,-1,-100.0,KATAMEI
BQ-CC83,1,2,-1,-100.0,KATAMEI
RTWS04WH,1,2,-1,-100.0,KATAMEI
6634AQOS6HB,1,2,-1,-100.0,KATAMEI
LR6(T)2B,1,2,-1,-100.0,KATAMEI
LR43P,6,12,-6,-100.0,KATAMEI
VW-ACT380-K,1,2,-1,-100.0,KATAMEI
DH-HD14EM10BK,1,2,-1,-100.0,KATAMEI
LR20XJV/6SW,5,10,-5,-100.0,KATAMEI
VVVDR12JP50,1,2,-1,-100.0,KATAMEI
FHC66ED-LE-SHG2,2,4,-2,-100.0,KATAMEI
6793KNTN2PHB,1,2,-1,-100.0,KATAMEI
LR20EM/10S,1,2,-1,-100.0,KATAMEI
GST3262IP154,1,2,-1,-100.0,KATAMEI
MDRXB55L,1,2,-1,-100.0,KATAMEI
SL-002ANV,2,4,-2,-100.0,KATAMEI
MHCA2101WH,4,8,-4,-100.0,KATAMEI
ACDC-1965FUBK,1,2,-1,-100.0,KATAMEI
AXW3215-9SG0,1,2,-1,-100.0,KATAMEI
RTWS05MT,1,2,-1,-100.0,KATAMEI
SAT-C,1,2,-1,-100.0,KATAMEI
AKB-100(BL),2,4,-2,-100.0,KATAMEI
41-945162,1,2,-1,-100.0,KATAMEI
MS-TW33BK,1,2,-1,-100.0,KATAMEI
MH-CT21H(W),1,2,-1,-100.0,KATAMEI
MR-K009WH,1,2,-1,-100.0,KATAMEI
GP3225AQOW,1,2,-1,-100.0,KATAMEI
MPA-CHDMIABK,1,2,-1,-100.0,KATAMEI
MPA-CCPD08BK,1,2,-1,-100.0,KATAMEI
MPA-AMBCC20BK,1,2,-1,-100.0,KATAMEI
SCT2LLW-P,1,2,-1,-100.0,KATAMEI
MPA-ACL06WF,1,2,-1,-100.0,KATAMEI
FCL30ECW28XCF32K,3,6,-3,-100.0,KATAMEI
TSC149CA05W,3,6,-3,-100.0,KATAMEI
MHD-1233-AG,1,2,-1,-100.0,KATAMEI
FCL30ENW28MCF32K,1,2,-1,-100.0,KATAMEI
MPA-UALPS10PN,1,2,-1,-100.0,KATAMEI
MS-7LBK-N,19,35,-16,-84.21,KATAMEI
LR44EM/2BP,12,22,-10,-83.33,KATAMEI
LR03NJ/2B,18,33,-15,-83.33,KATAMEI
LR6EJV/12SW,33,60,-27,-81.82,KATAMEI
TAP-TSH42N,5,9,-4,-80.0,KATAMEI
VHW12NP10V1,5,9,-4,-80.0,KATAMEI
FLR40SEXDMX36F3,5,9,-4,-80.0,KATAMEI
LR41EM/1BP,8,14,-6,-75.0,KATAMEI
A30HW,4,7,-3,-75.0,KATAMEI
AMC-HC12,7,12,-5,-71.43,KATAMEI
FL32SEXNF3,3,5,-2,-66.67,KATAMEI
TQ-750J-7JF,3,5,-2,-66.67,KATAMEI
G-13H(W),3,5,-2,-66.67,KATAMEI
MHS-2035-K,3,5,-2,-66.67,KATAMEI
FL10ENWF3,3,5,-2,-66.67,KATAMEI
TR-IP22M2-LCA-CCCC,3,5,-2,-66.67,KATAMEI
LDR9L-H-S8EDA,3,5,-2,-66.67,KATAMEI
ED-CLYS10WH,3,5,-2,-66.67,KATAMEI
6LF22HEC,3,5,-2,-66.67,KATAMEI
PM-A22SFLGF,3,5,-2,-66.67,KATAMEI
GW110V-60W/70,3,5,-2,-66.67,KATAMEI
WC-DP110N4,3,5,-2,-66.67,KATAMEI
CR2032EM/1BP,36,58,-22,-61.11,KATAMEI
FL6ENWF31P,5,8,-3,-60.0,KATAMEI
FCL3032ECWXCF32K,5,8,-3,-60.0,KATAMEI
6LR61XJ/1B,7,11,-4,-57.14,KATAMEI
WP3,17,26,-9,-52.94,KATAMEI
CAC-CHDMI10BK,2,3,-1,-50.0,KATAMEI
IDL-140J-7JF,2,3,-1,-50.0,KATAMEI
BC360,8,12,-4,-50.0,KATAMEI
LAM-FA4203,2,3,-1,-50.0,KATAMEI
PKB7MPB,2,3,-1,-50.0,KATAMEI
6922GA53BO,2,3,-1,-50.0,KATAMEI
SW80QM5V1,2,3,-1,-50.0,KATAMEI
TB-A22PMFLFANG,2,3,-1,-50.0,KATAMEI
PKU-FREE4,2,3,-1,-50.0,KATAMEI
VPF-5,4,6,-2,-50.0,KATAMEI
CDR700SWPS1P10S,2,3,-1,-50.0,KATAMEI
PM-A20BFLGGBL,2,3,-1,-50.0,KATAMEI
PM-A20BFLGGOBL,2,3,-1,-50.0,KATAMEI
PM-A20CFLGGBL,2,3,-1,-50.0,KATAMEI
SD-MIX30A,2,3,-1,-50.0,KATAMEI
BCI-331M,2,3,-1,-50.0,KATAMEI
BCI-321GY,2,3,-1,-50.0,KATAMEI
WI-XB400 B,2,3,-1,-50.0,KATAMEI
MPA-ACL02WF,2,3,-1,-50.0,KATAMEI
FHD100ENWLCF3,2,3,-1,-50.0,KATAMEI
PM-A22APLFYRD,2,3,-1,-50.0,KATAMEI
TB-A20MFLFANGN,2,3,-1,-50.0,KATAMEI
P351754C,4,6,-2,-50.0,KATAMEI
TR-IP21S-GLS-CC,2,3,-1,-50.0,KATAMEI
T-ST02N-2330WH,2,3,-1,-50.0,KATAMEI
LC-G-5MP,2,3,-1,-50.0,KATAMEI
MA-SBL188R,2,3,-1,-50.0,KATAMEI
TSA51UK,2,3,-1,-50.0,KATAMEI
MPA-UALS12WH,2,3,-1,-50.0,KATAMEI
TZE-221,4,6,-2,-50.0,KATAMEI
RLI050M2A02WH,4,6,-2,-50.0,KATAMEI
LS105WUCBL,2,3,-1,-50.0,KATAMEI
LDA11L-G/100V1,2,3,-1,-50.0,KATAMEI
MPA-XL35DS01GD,2,3,-1,-50.0,KATAMEI
S-3ES21S,2,3,-1,-50.0,KATAMEI
FL20SSECW18XCF3,2,3,-1,-50.0,KATAMEI
RTWS05LP,2,3,-1,-50.0,KATAMEI
SAT-LC,2,3,-1,-50.0,KATAMEI
QL-0409PK,2,3,-1,-50.0,KATAMEI
P-TPS03RD,2,3,-1,-50.0,KATAMEI
MPC-C6700PWH,2,3,-1,-50.0,KATAMEI
4RL432-019,2,3,-1,-50.0,KATAMEI
DRD215WPE.10S,2,3,-1,-50.0,KATAMEI
TRP-5880X5,2,3,-1,-50.0,KATAMEI
LW100V57W-W-2P,8,12,-4,-50.0,KATAMEI
MPA-UALPS20RD,2,3,-1,-50.0,KATAMEI
LR6NJ/12SW,33,48,-15,-45.45,KATAMEI
FHF32EXNHF3,7,10,-3,-42.86,KATAMEI
RHEC35D02SV,7,10,-3,-42.86,KATAMEI
FHC2734ECW2CF32K,7,10,-3,-42.86,KATAMEI
EH-NE4J-N,12,17,-5,-41.67,KATAMEI
LR6EJV/20SW,5,7,-2,-40.0,KATAMEI
LR44EM/1BP,8,11,-3,-37.5,KATAMEI
FLR40SEXDMX36F32K,11,15,-4,-36.36,KATAMEI
41-945124,3,4,-1,-33.33,KATAMEI
LDA7L-G-FC,6,8,-2,-33.33,KATAMEI
LR03NJ/4B,21,28,-7,-33.33,KATAMEI
TT250A-P,3,4,-1,-33.33,KATAMEI
DQD-710J-8JF,3,4,-1,-33.33,KATAMEI
LR03EM/8S,6,8,-2,-33.33,KATAMEI
WBT-N3020B(BK),3,4,-1,-33.33,KATAMEI
PGI1300XLBK,3,4,-1,-33.33,KATAMEI
A3982N11,3,4,-1,-33.33,KATAMEI
KHS-8730/W,3,4,-1,-33.33,KATAMEI
TT490A-K,3,4,-1,-33.33,KATAMEI
WHA2524WKP,3,4,-1,-33.33,KATAMEI
TQ-478-8JF,3,4,-1,-33.33,KATAMEI
CR-123AW,9,12,-3,-33.33,KATAMEI
LZ-NC100,3,4,-1,-33.33,KATAMEI
M-1012,3,4,-1,-33.33,KATAMEI
HAR-C,3,4,-1,-33.33,KATAMEI
HR-101SA4,3,4,-1,-33.33,KATAMEI
MA-SBL188BK,6,8,-2,-33.33,KATAMEI
RF-NA35R-S,3,4,-1,-33.33,KATAMEI
CR1632EM/2BP,6,8,-2,-33.33,KATAMEI
CR-2032/4H,12,16,-4,-33.33,KATAMEI
P351754C2P,10,13,-3,-30.0,KATAMEI
FL40SSECW37F32K,7,9,-2,-28.57,KATAMEI
DW120WPA.5S,7,9,-2,-28.57,KATAMEI
EW0800-W,11,14,-3,-27.27,KATAMEI
LR20NJ/4SW,15,19,-4,-26.67,KATAMEI
W-1511NB(W),4,5,-1,-25.0,KATAMEI
LR20AN 4MP,4,5,-1,-25.0,KATAMEI
ESLP2,4,5,-1,-25.0,KATAMEI
ED-CCYS10RD,4,5,-1,-25.0,KATAMEI
MPA-ACC20WH,4,5,-1,-25.0,KATAMEI
LDA7D-G/60V1,4,5,-1,-25.0,KATAMEI
ED-CCYS10BK,4,5,-1,-25.0,KATAMEI
LR20NJ/2SE,9,11,-2,-22.22,KATAMEI
JNR-503PSC,5,6,-1,-20.0,KATAMEI
L100V57W-C,5,6,-1,-20.0,KATAMEI
LR20AN 2KP,5,6,-1,-20.0,KATAMEI
G-L14HC,5,6,-1,-20.0,KATAMEI
FDL18EXLCF3,5,6,-1,-20.0,KATAMEI
LR20XJV/4SW,5,6,-1,-20.0,KATAMEI
LR6NJ/4B,28,33,-5,-17.86,KATAMEI
WBT-N3030B(W),6,7,-1,-16.67,KATAMEI
LR6NJ/8SW,67,78,-11,-16.42,KATAMEI
LW100V57W-W,19,22,-3,-15.79,KATAMEI
WF-LS900N L,7,8,-1,-14.29,KATAMEI
FL40SSECW37F3,8,9,-1,-12.5,KATAMEI
T-KST02-22330WH,9,10,-1,-11.11,KATAMEI
P351736F2P,20,22,-2,-10.0,KATAMEI
LR03NJ/8SW,44,48,-4,-9.09,KATAMEI
ｷﾂﾁﾝﾍﾟ-ﾊﾟ-75ｸﾐ,439,459,-20,-4.56,KATAMEI
