TITLE,SGY_JSK_QTY_2023-04-15,SGY_JSK_QTY_2023-03-15,CHANGE_AMOUNT,CHANGE(%),CATEGORY
近畿法人営業１課,506,4,-502,-99.21,NIUKE_NM
西脇店(客注),58,1,-57,-98.28,NIUKE_NM
近畿法人営業２課,67,2,-65,-97.01,NIUKE_NM
新加古川店(理美容),35,2,-33,-94.29,NIUKE_NM
三木店(理美容),30,2,-28,-93.33,NIUKE_NM
MFS 池田駅前店,14,1,-13,-92.86,NIUKE_NM
ビバシティ彦根店(情報),38,3,-35,-92.11,NIUKE_NM
高槻宮田店(理美容),75,6,-69,-92.0,NIUKE_NM
MFS 四条河原町店,9,1,-8,-88.89,NIUKE_NM
★東大阪店(理美容),34,4,-30,-88.24,NIUKE_NM
太子店(理美容),50,6,-44,-88.0,NIUKE_NM
★大津店(理美容),32,4,-28,-87.5,NIUKE_NM
★八尾南店(客注),24,3,-21,-87.5,NIUKE_NM
★高槻店(理美容),28,4,-24,-85.71,NIUKE_NM
★神戸北町店(理美容),63,9,-54,-85.71,NIUKE_NM
松井山手店(理美容),28,4,-24,-85.71,NIUKE_NM
EFS 清和台店,7,1,-6,-85.71,NIUKE_NM
もりのみや店(理美容),48,7,-41,-85.42,NIUKE_NM
岸和田店(理美容),34,5,-29,-85.29,NIUKE_NM
塚口店(理美容),27,4,-23,-85.19,NIUKE_NM
西明石店(理美容),31,5,-26,-83.87,NIUKE_NM
MFS おおさかでんき上町台店,17,3,-14,-82.35,NIUKE_NM
オアシスタウンキセラ川西店(理美容),33,6,-27,-81.82,NIUKE_NM
MFS ＪＯＹたきぐち,55,10,-45,-81.82,NIUKE_NM
西宮店(消耗家電),516,96,-420,-81.4,NIUKE_NM
MFS 豊中曽根店,16,3,-13,-81.25,NIUKE_NM
イオン福知山店(ＡＶ),5,1,-4,-80.0,NIUKE_NM
西明石店(客注),5,1,-4,-80.0,NIUKE_NM
京都ファミリー店(客注),5,1,-4,-80.0,NIUKE_NM
西明石店(ＡＶ),18,4,-14,-77.78,NIUKE_NM
イオンタウン湖南店(客注),13,3,-10,-76.92,NIUKE_NM
西宮店(理美容),66,16,-50,-75.76,NIUKE_NM
エコール・リラ店(理美容),8,2,-6,-75.0,NIUKE_NM
なかもず店(理美容),40,10,-30,-75.0,NIUKE_NM
門真店(理美容),28,7,-21,-75.0,NIUKE_NM
中環東大阪店(客注),4,1,-3,-75.0,NIUKE_NM
みてじま店(理美容),27,7,-20,-74.07,NIUKE_NM
箕面船場店(理美容),30,8,-22,-73.33,NIUKE_NM
★八尾南店(理美容),54,15,-39,-72.22,NIUKE_NM
泉北店(理美容),63,18,-45,-71.43,NIUKE_NM
河内長野店(客注),7,2,-5,-71.43,NIUKE_NM
新守山店(理美容),38,11,-27,-71.05,NIUKE_NM
門真店(消耗家電),24,7,-17,-70.83,NIUKE_NM
MFS 能勢口駅前店,10,3,-7,-70.0,NIUKE_NM
八尾店(理美容),39,12,-27,-69.23,NIUKE_NM
ＪＲ尼崎駅店(理美容),64,20,-44,-68.75,NIUKE_NM
堺店(理美容),38,12,-26,-68.42,NIUKE_NM
堺インター店(理美容),28,9,-19,-67.86,NIUKE_NM
木津川店(ＡＶ),3,1,-2,-66.67,NIUKE_NM
赤穂店(客注),3,1,-2,-66.67,NIUKE_NM
くずはモール店(客注),3,1,-2,-66.67,NIUKE_NM
宝塚店(客注),3,1,-2,-66.67,NIUKE_NM
水口店(理美容),27,9,-18,-66.67,NIUKE_NM
円町店(理美容),72,24,-48,-66.67,NIUKE_NM
宝塚店(理美容),27,9,-18,-66.67,NIUKE_NM
ホテルモントレ姫路店(消耗家電),66,23,-43,-65.15,NIUKE_NM
枚方店(理美容),36,13,-23,-63.89,NIUKE_NM
河内長野店(理美容),38,14,-24,-63.16,NIUKE_NM
ＪＲ芦屋駅店,190,70,-120,-63.16,NIUKE_NM
ホテルモントレ姫路店(理美容),29,11,-18,-62.07,NIUKE_NM
久御山店(理美容),26,10,-16,-61.54,NIUKE_NM
京都ファミリー店(ＡＶ),10,4,-6,-60.0,NIUKE_NM
★高槻店(消耗家電),32,13,-19,-59.38,NIUKE_NM
御影店(理美容),66,27,-39,-59.09,NIUKE_NM
★オアシスタウン吹田SST店(客注),12,5,-7,-58.33,NIUKE_NM
おしくま店(理美容),45,19,-26,-57.78,NIUKE_NM
★姫路店(理美容),59,25,-34,-57.63,NIUKE_NM
ビバモール美原南インター店(生活),139,59,-80,-57.55,NIUKE_NM
天満橋店(理美容),40,17,-23,-57.5,NIUKE_NM
伊丹店(理美容),77,33,-44,-57.14,NIUKE_NM
EFS 柴原店,7,3,-4,-57.14,NIUKE_NM
オアシスタウンキセラ川西店(客注),7,3,-4,-57.14,NIUKE_NM
豊中店(消耗家電),102,46,-56,-54.9,NIUKE_NM
福崎店(生活),177,81,-96,-54.24,NIUKE_NM
イオンモール橿原店(理美容),53,25,-28,-52.83,NIUKE_NM
泉大津店(消耗家電),36,17,-19,-52.78,NIUKE_NM
豊中店(理美容),67,32,-35,-52.24,NIUKE_NM
岸和田店(客注),2,1,-1,-50.0,NIUKE_NM
みてじま店(客注),4,2,-2,-50.0,NIUKE_NM
アルプラザ近江八幡店(客注),2,1,-1,-50.0,NIUKE_NM
イオンタウン湖南店(消耗家電),22,11,-11,-50.0,NIUKE_NM
イオンモール北大路店(客注),4,2,-2,-50.0,NIUKE_NM
河内長野店(消耗家電),64,32,-32,-50.0,NIUKE_NM
東淡路店(理美容),32,16,-16,-50.0,NIUKE_NM
東近江店(ＡＶ),2,1,-1,-50.0,NIUKE_NM
ＪＲ尼崎駅店(客注),4,2,-2,-50.0,NIUKE_NM
新大和小泉店(客注),2,1,-1,-50.0,NIUKE_NM
★イオン洛南店(生活),182,92,-90,-49.45,NIUKE_NM
くずはモール店(理美容),43,22,-21,-48.84,NIUKE_NM
塚口店(生活),140,72,-68,-48.57,NIUKE_NM
中環東大阪店(消耗家電),86,45,-41,-47.67,NIUKE_NM
ブルメールＨＡＴ神戸店(生活),189,99,-90,-47.62,NIUKE_NM
養父店(生活),89,47,-42,-47.19,NIUKE_NM
イオンモール堺北花田店(ＡＶ),11,6,-5,-45.45,NIUKE_NM
京橋店(理美容),29,16,-13,-44.83,NIUKE_NM
イズミヤ長岡店(生活),210,117,-93,-44.29,NIUKE_NM
泉大津店(理美容),34,19,-15,-44.12,NIUKE_NM
★東大阪店(消耗家電),41,23,-18,-43.9,NIUKE_NM
久御山店(消耗家電),26,15,-11,-42.31,NIUKE_NM
イオン三田ＷＴ店(生活),183,106,-77,-42.08,NIUKE_NM
★オアシスタウン吹田SST店(生活),231,134,-97,-41.99,NIUKE_NM
★姫路店(ＡＶ),12,7,-5,-41.67,NIUKE_NM
★大津店(ＡＶ),5,3,-2,-40.0,NIUKE_NM
★八尾南店(消耗家電),69,42,-27,-39.13,NIUKE_NM
ＪＲ尼崎駅店(ＡＶ),23,14,-9,-39.13,NIUKE_NM
なかもず店(消耗家電),36,22,-14,-38.89,NIUKE_NM
ベルファ都島店(ＡＶ),13,8,-5,-38.46,NIUKE_NM
京橋店(消耗家電),48,30,-18,-37.5,NIUKE_NM
EFS 電器ランド,8,5,-3,-37.5,NIUKE_NM
近鉄上本町店(生活),140,88,-52,-37.14,NIUKE_NM
社店(生活),100,63,-37,-37.0,NIUKE_NM
洛北阪急スクエア店(情報),107,68,-39,-36.45,NIUKE_NM
ミ・ナーラ店(生活),110,70,-40,-36.36,NIUKE_NM
赤穂店(ＡＶ),11,7,-4,-36.36,NIUKE_NM
ららぽーと和泉店(生活),102,65,-37,-36.27,NIUKE_NM
★ららぽーとEXPOCITY店(理美容),36,23,-13,-36.11,NIUKE_NM
松井山手店(情報),32,21,-11,-34.38,NIUKE_NM
トナリエ南千里店(生活),221,146,-75,-33.94,NIUKE_NM
★イオンモール茨木店(生活),117,78,-39,-33.33,NIUKE_NM
MFS 御津店,3,2,-1,-33.33,NIUKE_NM
太子店(客注),3,2,-1,-33.33,NIUKE_NM
垂水店(理美容),60,40,-20,-33.33,NIUKE_NM
イオンタウン湖南店(理美容),6,4,-2,-33.33,NIUKE_NM
洛北阪急スクエア店(生活),261,176,-85,-32.57,NIUKE_NM
ダイエー光明池店(生活),96,65,-31,-32.29,NIUKE_NM
京都ファミリー店(情報),85,58,-27,-31.76,NIUKE_NM
★ららぽーとEXPOCITY店(消耗家電),35,24,-11,-31.43,NIUKE_NM
堺店(情報),86,59,-27,-31.4,NIUKE_NM
松井山手店(生活),142,98,-44,-30.99,NIUKE_NM
フォレオ大阪DC店(生活),113,79,-34,-30.09,NIUKE_NM
MFS みうらでんき豊野店,10,7,-3,-30.0,NIUKE_NM
イズミヤ長岡店(ＡＶ),10,7,-3,-30.0,NIUKE_NM
ニッケパークタウン店(ＡＶ),10,7,-3,-30.0,NIUKE_NM
大蔵谷店(情報),47,33,-14,-29.79,NIUKE_NM
大蔵谷店(生活),165,116,-49,-29.7,NIUKE_NM
もりのみや店(消耗家電),44,31,-13,-29.55,NIUKE_NM
★高槻店(ＡＶ),7,5,-2,-28.57,NIUKE_NM
なかもず店(ＡＶ),7,5,-2,-28.57,NIUKE_NM
イオンモール橿原店(生活),185,133,-52,-28.11,NIUKE_NM
宝塚店(消耗家電),27,20,-7,-25.93,NIUKE_NM
東淡路店(消耗家電),39,29,-10,-25.64,NIUKE_NM
西脇店(生活),98,73,-25,-25.51,NIUKE_NM
なんば本店(02 2階),176,132,-44,-25.0,NIUKE_NM
MFS 長居公園東店,4,3,-1,-25.0,NIUKE_NM
イオン福知山店(生活),80,60,-20,-25.0,NIUKE_NM
茨木藤の里店(ＡＶ),4,3,-1,-25.0,NIUKE_NM
箕面船場店(生活),130,98,-32,-24.62,NIUKE_NM
★豊岡店(生活),82,62,-20,-24.39,NIUKE_NM
堺石津店(生活),174,132,-42,-24.14,NIUKE_NM
★イオンモール和歌山店(生活),105,80,-25,-23.81,NIUKE_NM
★イオンモール茨木店(情報),59,45,-14,-23.73,NIUKE_NM
イオンモール北大路店(情報),126,97,-29,-23.02,NIUKE_NM
ミ・ナーラ店(情報),22,17,-5,-22.73,NIUKE_NM
松井山手店(消耗家電),31,24,-7,-22.58,NIUKE_NM
新亀岡店(客注),9,7,-2,-22.22,NIUKE_NM
外環大東店(理美容),9,7,-2,-22.22,NIUKE_NM
もりのみや店(情報),100,78,-22,-22.0,NIUKE_NM
エコール・リラ店(消耗家電),19,15,-4,-21.05,NIUKE_NM
新守山店(消耗家電),29,23,-6,-20.69,NIUKE_NM
ＩＹ明石(生活),213,170,-43,-20.19,NIUKE_NM
★オアシスタウン吹田SST店(情報),30,24,-6,-20.0,NIUKE_NM
西明石店(消耗家電),45,36,-9,-20.0,NIUKE_NM
イオンモール神戸北(ＡＶ),5,4,-1,-20.0,NIUKE_NM
ホームズ寝屋川店(生活),181,145,-36,-19.89,NIUKE_NM
京都四条河原町店(02_５Ｆ),55,45,-10,-18.18,NIUKE_NM
かいばら店(情報),28,23,-5,-17.86,NIUKE_NM
東近江店(生活),81,67,-14,-17.28,NIUKE_NM
おしくま店(消耗家電),42,35,-7,-16.67,NIUKE_NM
イオンモール北大路店(生活),234,196,-38,-16.24,NIUKE_NM
泉北店(消耗家電),38,32,-6,-15.79,NIUKE_NM
★大津店(情報),26,22,-4,-15.38,NIUKE_NM
立花店(ＡＶ),7,6,-1,-14.29,NIUKE_NM
★大津店(消耗家電),14,12,-2,-14.29,NIUKE_NM
★神戸北町店(消耗家電),78,67,-11,-14.1,NIUKE_NM
★イオン洛南店(情報),62,54,-8,-12.9,NIUKE_NM
★高槻店(生活),110,96,-14,-12.73,NIUKE_NM
水口店(生活),151,132,-19,-12.58,NIUKE_NM
久御山店(ＡＶ),8,7,-1,-12.5,NIUKE_NM
京橋店(ＡＶ),8,7,-1,-12.5,NIUKE_NM
西宮店(ＡＶ),58,51,-7,-12.07,NIUKE_NM
なんば本店(04 4階),201,179,-22,-10.95,NIUKE_NM
松坂屋高槻店(生活),205,183,-22,-10.73,NIUKE_NM
塚口店(消耗家電),19,17,-2,-10.53,NIUKE_NM
姫路花田店(生活),166,149,-17,-10.24,NIUKE_NM
西宮店(情報),122,110,-12,-9.84,NIUKE_NM
和歌山加納店(生活),72,65,-7,-9.72,NIUKE_NM
舞鶴店(生活),94,85,-9,-9.57,NIUKE_NM
水口店(情報),58,53,-5,-8.62,NIUKE_NM
オアシスタウンキセラ川西店(ＡＶ),12,11,-1,-8.33,NIUKE_NM
泉大津店(情報),37,34,-3,-8.11,NIUKE_NM
洛西店(生活),103,95,-8,-7.77,NIUKE_NM
立花店(生活),133,123,-10,-7.52,NIUKE_NM
ベルファ都島店(生活),243,225,-18,-7.41,NIUKE_NM
アルプラザ近江八幡店(生活),118,110,-8,-6.78,NIUKE_NM
西代店(生活),208,194,-14,-6.73,NIUKE_NM
六地蔵MOMOT店(情報),61,57,-4,-6.56,NIUKE_NM
円町店(消耗家電),79,74,-5,-6.33,NIUKE_NM
洛北阪急スクエア店(ＡＶ),17,16,-1,-5.88,NIUKE_NM
京橋店(情報),69,65,-4,-5.8,NIUKE_NM
六地蔵MOMOT店(生活),197,186,-11,-5.58,NIUKE_NM
もりのみや店(生活),240,227,-13,-5.42,NIUKE_NM
くずはモール店(情報),150,142,-8,-5.33,NIUKE_NM
宝ヶ池店(生活),124,118,-6,-4.84,NIUKE_NM
天満橋店(消耗家電),69,66,-3,-4.35,NIUKE_NM
エコール・リラ店(生活),69,66,-3,-4.35,NIUKE_NM
東淡路店(情報),52,50,-2,-3.85,NIUKE_NM
大津一里山店(生活),250,241,-9,-3.6,NIUKE_NM
新亀岡店(生活),172,166,-6,-3.49,NIUKE_NM
京都四条河原町店(01_１Ｆ),242,236,-6,-2.48,NIUKE_NM
堺店(消耗家電),43,42,-1,-2.33,NIUKE_NM
なんば本店(08 8階),355,347,-8,-2.25,NIUKE_NM
オアシスタウンキセラ川西店(消耗家電),45,44,-1,-2.22,NIUKE_NM
ホテルモントレ姫路店(情報),98,96,-2,-2.04,NIUKE_NM
中環東大阪店(理美容),66,65,-1,-1.52,NIUKE_NM
