TITLE,SGY_JSK_QTY_2023-04-15,SGY_JSK_QTY_2023-03-15,CHANGE_AMOUNT,CHANGE(%),CATEGORY
815,2136,11,-2125,-99.49,TANKA
640,1225,62,-1163,-94.94,TANKA
940,865,2,-863,-99.77,TANKA
588,875,208,-667,-76.23,TANKA
155,470,5,-465,-98.94,TANKA
7559,444,2,-442,-99.55,TANKA
400,458,20,-438,-95.63,TANKA
645,405,4,-401,-99.01,TANKA
1070,457,61,-396,-86.65,TANKA
320,391,15,-376,-96.16,TANKA
70,1160,789,-371,-31.98,TANKA
1155,427,69,-358,-83.84,TANKA
338,402,57,-345,-85.82,TANKA
1040,408,92,-316,-77.45,TANKA
5306,300,11,-289,-96.33,TANKA
698,310,29,-281,-90.65,TANKA
426,280,2,-278,-99.29,TANKA
3250,276,12,-264,-95.65,TANKA
128,260,6,-254,-97.69,TANKA
250,289,37,-252,-87.2,TANKA
494,256,11,-245,-95.7,TANKA
1441,227,11,-216,-95.15,TANKA
535,229,25,-204,-89.08,TANKA
1189,238,44,-194,-81.51,TANKA
325,233,40,-193,-82.83,TANKA
4186,190,6,-184,-96.84,TANKA
2263,183,1,-182,-99.45,TANKA
660,190,18,-172,-90.53,TANKA
341,178,22,-156,-87.64,TANKA
990,194,48,-146,-75.26,TANKA
4567,150,7,-143,-95.33,TANKA
1003,143,8,-135,-94.41,TANKA
4123,176,69,-107,-60.8,TANKA
3386,112,6,-106,-94.64,TANKA
4886,120,19,-101,-84.17,TANKA
122,100,2,-98,-98.0,TANKA
1686,95,3,-92,-96.84,TANKA
6286,91,1,-90,-98.9,TANKA
6676,91,4,-87,-95.6,TANKA
5117,92,6,-86,-93.48,TANKA
666,91,8,-83,-91.21,TANKA
175,100,21,-79,-79.0,TANKA
2366,71,3,-68,-95.77,TANKA
143,258,192,-66,-25.58,TANKA
117,67,3,-64,-95.52,TANKA
1030,68,5,-63,-92.65,TANKA
2495,67,7,-60,-89.55,TANKA
195,68,12,-56,-82.35,TANKA
750,167,112,-55,-32.93,TANKA
700,101,49,-52,-51.49,TANKA
468,79,34,-45,-56.96,TANKA
348,43,2,-41,-95.35,TANKA
268,45,5,-40,-88.89,TANKA
2340,54,14,-40,-74.07,TANKA
10054,39,1,-38,-97.44,TANKA
1417,40,2,-38,-95.0,TANKA
3360,48,10,-38,-79.17,TANKA
2610,41,4,-37,-90.24,TANKA
1898,63,26,-37,-58.73,TANKA
192,47,11,-36,-76.6,TANKA
2026,55,20,-35,-63.64,TANKA
147,124,89,-35,-28.23,TANKA
1512,58,24,-34,-58.62,TANKA
1946,36,6,-30,-83.33,TANKA
301,51,21,-30,-58.82,TANKA
1225,33,4,-29,-87.88,TANKA
2086,69,41,-28,-40.58,TANKA
76500,29,1,-28,-96.55,TANKA
1467,28,2,-26,-92.86,TANKA
827,26,2,-24,-92.31,TANKA
1063,38,15,-23,-60.53,TANKA
1859,23,1,-22,-95.65,TANKA
1248,23,1,-22,-95.65,TANKA
238,23,1,-22,-95.65,TANKA
823,32,11,-21,-65.62,TANKA
567,65,44,-21,-32.31,TANKA
177,47,27,-20,-42.55,TANKA
1639,29,10,-19,-65.52,TANKA
507,22,3,-19,-86.36,TANKA
2990,20,1,-19,-95.0,TANKA
1009,28,9,-19,-67.86,TANKA
74,736,717,-19,-2.58,TANKA
960,72,53,-19,-26.39,TANKA
585,40,22,-18,-45.0,TANKA
327,20,2,-18,-90.0,TANKA
650,37,19,-18,-48.65,TANKA
5740,19,1,-18,-94.74,TANKA
1740,48,31,-17,-35.42,TANKA
2380,20,3,-17,-85.0,TANKA
1495,30,15,-15,-50.0,TANKA
2015,20,5,-15,-75.0,TANKA
704,22,8,-14,-63.64,TANKA
10805,20,6,-14,-70.0,TANKA
1059,17,3,-14,-82.35,TANKA
1244,19,5,-14,-73.68,TANKA
1890,26,12,-14,-53.85,TANKA
19200,21,8,-13,-61.9,TANKA
3169,14,1,-13,-92.86,TANKA
408,27,14,-13,-48.15,TANKA
627,23,10,-13,-56.52,TANKA
949,15,3,-12,-80.0,TANKA
306,13,1,-12,-92.31,TANKA
455,25,13,-12,-48.0,TANKA
794,20,8,-12,-60.0,TANKA
910,24,12,-12,-50.0,TANKA
2989,12,1,-11,-91.67,TANKA
1736,14,3,-11,-78.57,TANKA
2000,22,11,-11,-50.0,TANKA
1090,27,16,-11,-40.74,TANKA
1303,13,2,-11,-84.62,TANKA
279,33,22,-11,-33.33,TANKA
6650,12,2,-10,-83.33,TANKA
1033,12,2,-10,-83.33,TANKA
5600,16,6,-10,-62.5,TANKA
2275,19,9,-10,-52.63,TANKA
162,11,1,-10,-90.91,TANKA
1891,12,2,-10,-83.33,TANKA
759,15,5,-10,-66.67,TANKA
449,11,1,-10,-90.91,TANKA
3185,14,4,-10,-71.43,TANKA
270,28,19,-9,-32.14,TANKA
3487,10,1,-9,-90.0,TANKA
2081,10,1,-9,-90.0,TANKA
11700,19,10,-9,-47.37,TANKA
2160,15,6,-9,-60.0,TANKA
2128,12,3,-9,-75.0,TANKA
287,10,1,-9,-90.0,TANKA
1224,11,2,-9,-81.82,TANKA
2436,18,10,-8,-44.44,TANKA
14000,9,1,-8,-88.89,TANKA
11475,15,7,-8,-53.33,TANKA
504,34,26,-8,-23.53,TANKA
600,28,20,-8,-28.57,TANKA
584,11,3,-8,-72.73,TANKA
5100,18,10,-8,-44.44,TANKA
137,9,1,-8,-88.89,TANKA
22960,9,2,-7,-77.78,TANKA
434,8,1,-7,-87.5,TANKA
580,18,11,-7,-38.89,TANKA
2145,39,32,-7,-17.95,TANKA
5586,8,1,-7,-87.5,TANKA
316,10,4,-6,-60.0,TANKA
918,7,1,-6,-85.71,TANKA
2480,7,1,-6,-85.71,TANKA
2388,13,7,-6,-46.15,TANKA
3887,10,4,-6,-60.0,TANKA
873,7,1,-6,-85.71,TANKA
460,11,5,-6,-54.55,TANKA
104,62,56,-6,-9.68,TANKA
12600,8,2,-6,-75.0,TANKA
324,22,16,-6,-27.27,TANKA
634,7,1,-6,-85.71,TANKA
828,9,3,-6,-66.67,TANKA
1138,12,7,-5,-41.67,TANKA
2153,7,2,-5,-71.43,TANKA
761,6,1,-5,-83.33,TANKA
448,24,19,-5,-20.83,TANKA
19110,6,1,-5,-83.33,TANKA
1310,11,6,-5,-45.45,TANKA
1347,22,17,-5,-22.73,TANKA
1430,8,3,-5,-62.5,TANKA
3750,6,1,-5,-83.33,TANKA
962,12,7,-5,-41.67,TANKA
1091,8,3,-5,-62.5,TANKA
3200,6,1,-5,-83.33,TANKA
606,30,25,-5,-16.67,TANKA
3136,6,2,-4,-66.67,TANKA
219,6,2,-4,-66.67,TANKA
1013,5,1,-4,-80.0,TANKA
1092,8,4,-4,-50.0,TANKA
641,9,5,-4,-44.44,TANKA
664,6,2,-4,-66.67,TANKA
1800,8,4,-4,-50.0,TANKA
716,5,1,-4,-80.0,TANKA
1612,6,2,-4,-66.67,TANKA
762,5,1,-4,-80.0,TANKA
1461,9,5,-4,-44.44,TANKA
807,20,16,-4,-20.0,TANKA
896,5,1,-4,-80.0,TANKA
13860,5,1,-4,-80.0,TANKA
637,19,15,-4,-21.05,TANKA
2262,8,4,-4,-50.0,TANKA
1031,10,6,-4,-40.0,TANKA
1064,6,2,-4,-66.67,TANKA
319,5,1,-4,-80.0,TANKA
4442,5,1,-4,-80.0,TANKA
381,6,2,-4,-66.67,TANKA
349,6,2,-4,-66.67,TANKA
321,10,6,-4,-40.0,TANKA
1960,11,8,-3,-27.27,TANKA
1068,7,4,-3,-42.86,TANKA
1014,4,1,-3,-75.0,TANKA
1755,12,9,-3,-25.0,TANKA
167,4,1,-3,-75.0,TANKA
7101,4,1,-3,-75.0,TANKA
1428,5,2,-3,-60.0,TANKA
824,9,6,-3,-33.33,TANKA
891,14,11,-3,-21.43,TANKA
1680,6,3,-3,-50.0,TANKA
1848,4,1,-3,-75.0,TANKA
1105,29,26,-3,-10.34,TANKA
644,8,5,-3,-37.5,TANKA
2192,6,3,-3,-50.0,TANKA
10800,7,4,-3,-42.86,TANKA
715,18,15,-3,-16.67,TANKA
2030,7,4,-3,-42.86,TANKA
1025,5,2,-3,-60.0,TANKA
2940,12,9,-3,-25.0,TANKA
425,15,12,-3,-20.0,TANKA
1660,4,1,-3,-75.0,TANKA
1029,9,6,-3,-33.33,TANKA
2912,5,2,-3,-60.0,TANKA
280,12,9,-3,-25.0,TANKA
797,7,4,-3,-42.86,TANKA
3867,3,1,-2,-66.67,TANKA
311,5,3,-2,-40.0,TANKA
9600,3,1,-2,-66.67,TANKA
154,36,34,-2,-5.56,TANKA
2296,18,16,-2,-11.11,TANKA
6987,3,1,-2,-66.67,TANKA
1130,3,1,-2,-66.67,TANKA
14240,3,1,-2,-66.67,TANKA
364,12,10,-2,-16.67,TANKA
825,6,4,-2,-33.33,TANKA
1032,5,3,-2,-40.0,TANKA
2250,3,1,-2,-66.67,TANKA
10150,3,1,-2,-66.67,TANKA
1081,3,1,-2,-66.67,TANKA
3125,6,4,-2,-33.33,TANKA
1593,3,1,-2,-66.67,TANKA
2116,5,3,-2,-40.0,TANKA
1067,4,2,-2,-50.0,TANKA
5530,3,1,-2,-66.67,TANKA
347,6,4,-2,-33.33,TANKA
351,3,1,-2,-66.67,TANKA
1465,3,1,-2,-66.67,TANKA
224,4,2,-2,-50.0,TANKA
6480,3,1,-2,-66.67,TANKA
1677,3,1,-2,-66.67,TANKA
8176,3,1,-2,-66.67,TANKA
96,6,4,-2,-33.33,TANKA
3510,6,4,-2,-33.33,TANKA
1131,5,3,-2,-40.0,TANKA
394,3,1,-2,-66.67,TANKA
500,6,4,-2,-33.33,TANKA
1968,5,3,-2,-40.0,TANKA
7700,3,1,-2,-66.67,TANKA
2588,3,1,-2,-66.67,TANKA
508,4,2,-2,-50.0,TANKA
1185,3,1,-2,-66.67,TANKA
389,3,1,-2,-66.67,TANKA
343,5,3,-2,-40.0,TANKA
984,3,1,-2,-66.67,TANKA
1358,3,1,-2,-66.67,TANKA
7020,3,1,-2,-66.67,TANKA
996,3,1,-2,-66.67,TANKA
23400,2,1,-1,-50.0,TANKA
1034,2,1,-1,-50.0,TANKA
2007,6,5,-1,-16.67,TANKA
2023,2,1,-1,-50.0,TANKA
5443,2,1,-1,-50.0,TANKA
14400,2,1,-1,-50.0,TANKA
4536,2,1,-1,-50.0,TANKA
1456,11,10,-1,-9.09,TANKA
766,6,5,-1,-16.67,TANKA
1050,17,16,-1,-5.88,TANKA
9530,2,1,-1,-50.0,TANKA
980,23,22,-1,-4.35,TANKA
1806,3,2,-1,-33.33,TANKA
686,10,9,-1,-10.0,TANKA
96148,2,1,-1,-50.0,TANKA
1625,38,37,-1,-2.63,TANKA
826,7,6,-1,-14.29,TANKA
428,3,2,-1,-33.33,TANKA
15750,3,2,-1,-33.33,TANKA
1932,5,4,-1,-20.0,TANKA
652,2,1,-1,-50.0,TANKA
136,3,2,-1,-33.33,TANKA
1953,19,18,-1,-5.26,TANKA
1577,4,3,-1,-25.0,TANKA
829,18,17,-1,-5.56,TANKA
1603,2,1,-1,-50.0,TANKA
12714,2,1,-1,-50.0,TANKA
483,9,8,-1,-11.11,TANKA
1160,2,1,-1,-50.0,TANKA
2696,2,1,-1,-50.0,TANKA
1276,2,1,-1,-50.0,TANKA
495,2,1,-1,-50.0,TANKA
1249,2,1,-1,-50.0,TANKA
4000,2,1,-1,-50.0,TANKA
3640,5,4,-1,-20.0,TANKA
68,2,1,-1,-50.0,TANKA
890,8,7,-1,-12.5,TANKA
3900,4,3,-1,-25.0,TANKA
2389,2,1,-1,-50.0,TANKA
2394,2,1,-1,-50.0,TANKA
164,5,4,-1,-20.0,TANKA
1240,6,5,-1,-16.67,TANKA
3480,2,1,-1,-50.0,TANKA
27540,2,1,-1,-50.0,TANKA
3050,2,1,-1,-50.0,TANKA
1315,5,4,-1,-20.0,TANKA
3289,2,1,-1,-50.0,TANKA
1349,2,1,-1,-50.0,TANKA
850,2,1,-1,-50.0,TANKA
2082,2,1,-1,-50.0,TANKA
3184,2,1,-1,-50.0,TANKA
3315,5,4,-1,-20.0,TANKA
2085,2,1,-1,-50.0,TANKA
2571,2,1,-1,-50.0,TANKA
2851,2,1,-1,-50.0,TANKA
920,7,6,-1,-14.29,TANKA
4485,2,1,-1,-50.0,TANKA
2151,4,3,-1,-25.0,TANKA
3107,3,2,-1,-33.33,TANKA
4256,3,2,-1,-33.33,TANKA
2730,5,4,-1,-20.0,TANKA
